GenContext.norep	Lineage.final	count
PspC*->	bacteria>actinobacteria	107
<-PspC*	bacteria>firmicutes	64
<-PspC*<-PspB<-PspA	bacteria>proteobacteria>gammaproteobacteria	58
<-PspC*	bacteria>actinobacteria	55
PspA->PspB->PspC*->	bacteria>proteobacteria>gammaproteobacteria	49
<-PspC*	bacteria>other unclassified bacteria	47
<-PspC*	bacteria>proteobacteria>gammaproteobacteria	46
PspC*->	bacteria>firmicutes	43
<-PspC+TM(s)+Toast-rack*||PspC+TM(s)+HISKIN*->REC+LuxR-HTH->	bacteria>actinobacteria	42
PspC*->	bacteria>other unclassified bacteria	40
<-TM(s)+IIGP1<-CR-ATPase1<-Phageshock_PspD<-PspC*<-PspB<-PspA	bacteria>proteobacteria>gammaproteobacteria	38
<-Phageshock_PspD<-PspC*<-PspB<-PspA	bacteria>proteobacteria>gammaproteobacteria	31
<-PspC*<-?<-ComEA-HHH+S1	bacteria>firmicutes	31
PspC*->	bacteria>proteobacteria>gammaproteobacteria	31
ComEA-HHH+S1->?->PspC*->	bacteria>firmicutes	27
<-PspC*<-PspA	bacteria>proteobacteria>gammaproteobacteria	26
PspA->PspB->PspC*->CR-ATPase1->TM(s)+IIGP1->	bacteria>proteobacteria>gammaproteobacteria	24
PspA->PspB->PspC*->Phageshock_PspD->	bacteria>proteobacteria>gammaproteobacteria	23
<-TM(s)+IIGP1<-CR-ATPase1<-PspC*<-PspB<-PspA	bacteria>proteobacteria>gammaproteobacteria	22
<-PspC*	bacteria>fcb group	21
<-REC+LuxR-HTH<-PspC+TM(s)+HISKIN*||PspC+TM(s)+Toast-rack*->	bacteria>actinobacteria	21
PspC*->	bacteria>fcb group	17
PADR-HTH->DUF1700-alpha-helical+PspC+LiaI-LiaF-TM+Toast-rack*->	bacteria>fcb group	16
PspA->PspB->PspC*->Phageshock_PspD->CR-ATPase1->TM(s)+IIGP1->	bacteria>proteobacteria>gammaproteobacteria	16
<-PspA<-PspC*<-PspA	bacteria>firmicutes	15
PspC*->	bacteria>proteobacteria>alphaproteobacteria	15
<-DUF1700-alpha-helical+PspC+LiaI-LiaF-TM+Toast-rack*<-PADR-HTH	bacteria>fcb group	14
<-PspC*	archaea>euryarchaeota	13
<-TM||sf+TM(s)->?->?->PspC*->	bacteria>proteobacteria>gammaproteobacteria	13
HxxxH->PspC*->	bacteria>other unclassified bacteria	13
PspA->PspC*->	bacteria>proteobacteria>gammaproteobacteria	13
PspC*-><-CHTH+DSBH||?->SIG+TM(s)-><-?<-?<-ABC-ATPase	bacteria>firmicutes	13
<-PspC*	bacteria>proteobacteria>alphaproteobacteria	12
<-SIG+TM(s)<-PspC*<-PspC+Toast-rack*<-Toast-rack	bacteria>firmicutes	12
<-SIG+TM(s)<-PspC*<-Toast-rack	bacteria>firmicutes	12
<-DUF1700-alpha-helical+PspC+LiaI-LiaF-TM*<-PADR-HTH	bacteria>fcb group	11
<-PspC*<-?<-?<-SIG+HAMP+HISKIN<-REC+LuxR-HTH	bacteria>actinobacteria	11
<-PspC+TM(s)*||PspC+TM(s)+HISKIN*->REC+LuxR-HTH->	bacteria>actinobacteria	11
PspC+LiaI-LiaF-TM*->	bacteria>other unclassified bacteria	11
<-LiaI-LiaF-TM+Toast-rack<-PspC+LiaI-LiaF-TM*	bacteria>other unclassified bacteria	10
<-SIG+LTD+IG+Calcineurin<-SIG+TM(s)<-PspC*<-Toast-rack	bacteria>firmicutes	10
ABhydrolase->?-><-PspC+TM(s)+Toast-rack*||PspC+TM(s)+HISKIN*->REC+LuxR-HTH->	bacteria>actinobacteria	10
PADR-HTH->DUF1700-alpha-helical+PspC+LiaI-LiaF-TM+Toast-rack*->SIG+Toast-rack->	bacteria>fcb group	10
PspC*->	archaea>euryarchaeota	10
PspC+LiaI-LiaF-TM*->LiaI-LiaF-TM+Toast-rack->	bacteria>other unclassified bacteria	10
<-Cluster39_2clades<-?<-?<-?<-?<-?<-PspC*<-PspB<-PspA	bacteria>proteobacteria>alphaproteobacteria	9
<-PspA<-PspC*	bacteria>firmicutes	9
<-PspC(s)+LiaI-LiaF-TM+Toast-rack(s)*<-PADR-HTH	bacteria>fcb group	9
<-PspC+TM(s)+Toast-rack*	bacteria>actinobacteria	9
<-REC+LuxR-HTH<-PspC+TM(s)+HISKIN*||PspC+TM(s)+Toast-rack*->?-><-ABhydrolase	bacteria>actinobacteria	9
PADR-HTH->DUF1700-alpha-helical+PspC+LiaI-LiaF-TM*->	bacteria>other unclassified bacteria	9
PspC*->	bacteria>chloroflexi	9
Toast-rack->PspC*->SIG+TM(s)->	bacteria>firmicutes	9
<-PspC*<-PspB<-PspA	bacteria>proteobacteria>alphaproteobacteria	8
<-PspC*<-SIG+TM(s)	archaea>euryarchaeota	8
<-SIG+RHOD-CDC25<-Phageshock_PspD<-PspC*<-PspB<-PspA	bacteria>proteobacteria>gammaproteobacteria	8
<-SIG+TM(s)<-PspC*	bacteria>firmicutes	8
<-TM(s)+IIGP1<-CR-ATPase1<-Phageshock_PspD<-PspC*<-PspB	bacteria>proteobacteria>gammaproteobacteria	8
ENOYCOADEHYD-><-PspC*	bacteria>proteobacteria>gammaproteobacteria	8
PspA->PspB->PspC*->	bacteria>proteobacteria>alphaproteobacteria	8
PspC+LiaI-LiaF-TM*->	bacteria>firmicutes	8
<-LiaI-LiaF-TM+Toast-rack<-PspC+LiaI-LiaF-TM*||Cluster73_4clades->?->SIG+TM(s)->ABC-ATPase->ABC-ATPase->Cluster134_2clades->SIG+TM(s)->	bacteria>thermotogae	7
<-PspC*<-NUDIX	bacteria>other unclassified bacteria	7
<-SIG+TM(s)+FTSK(s)-HTH<-PspC*	bacteria>firmicutes	7
<-STAT<-TM(s)+IIGP1<-CR-ATPase1<-PspC*<-PspB<-PspA	bacteria>proteobacteria>gammaproteobacteria	7
GNTR-HTH+UTRA-><-SIG+LTD+IG+Calcineurin<-SIG+TM(s)<-PspC*<-Toast-rack	bacteria>firmicutes	7
PADR-HTH->DUF1700-alpha-helical+PspC+LiaI-LiaF-TM*->	bacteria>fcb group	7
PspA->PspB->PspC*->Phageshock_PspD->SIG+RHOD-CDC25->	bacteria>proteobacteria>gammaproteobacteria	7
PspC*-><-ENOYCOADEHYD	bacteria>proteobacteria>gammaproteobacteria	7
SIG+TM(s)-><-SIG+LTD+IG+Calcineurin<-SIG+TM(s)<-PspC*<-Toast-rack	bacteria>firmicutes	7
<-Cluster65_2clades||?-><-NtrC-AAA+FIS-HTH<-TM(s)+IIGP1<-CR-ATPase1<-Phageshock_PspD<-PspC*<-PspB<-PspA	bacteria>proteobacteria>gammaproteobacteria	6
<-PspC*<-?<-?<-sf+TM(s)||TM->	bacteria>proteobacteria>gammaproteobacteria	6
<-PspC+LiaI-LiaF-TM*	bacteria>other unclassified bacteria	6
PspA->PspB->PspC*->Phageshock_PspD->SIG+RHOD-CDC25->CR-ATPase1->TM(s)+IIGP1->	bacteria>proteobacteria>gammaproteobacteria	6
PspB->PspC*->Phageshock_PspD->CR-ATPase1->TM(s)+IIGP1->	bacteria>proteobacteria>gammaproteobacteria	6
PspC+LiaI-LiaF-TM*->LiaI-LiaF-TM+Toast-rack->	bacteria>firmicutes	6
SIG+TM(s)->ABC-ATPase->ABC-ATPase->SIG+TM(s)->?->SIG+TM(s)->PspC*->	archaea>euryarchaeota	6
<-Cluster322_2clades<-Cluster304_2clades<-?<-PspC+LiaI-LiaF-TM+Toast-rack*<-PADR-HTH	bacteria>other unclassified bacteria	5
<-EMAP<-SIG+TM(s)<-7TMR-HDED<-PspC*	bacteria>other unclassified bacteria	5
<-LiaI-LiaF-TM+Toast-rack<-PspC+LiaI-LiaF-TM*	bacteria>firmicutes	5
<-PspC*	bacteria>proteobacteria>deltaproteobacteria	5
<-PspC+LiaI-LiaF-TM*	bacteria>firmicutes	5
<-PspC+TM(s)+HISKIN*||PspC+TM(s)*->	bacteria>actinobacteria	5
<-REC+LuxR-HTH<-PspC+TM(s)+HISKIN*	bacteria>actinobacteria	5
<-REC+LuxR-HTH<-PspC+TM(s)+HISKIN*||PspC+TM(s)*->	bacteria>actinobacteria	5
<-SIG+TM(s)<-?<-PspC*<-Toast-rack	bacteria>firmicutes	5
<-SIG+TM(s)<-PspC*<-Toast-rack<-?<-SbcC(s)+ABC-ATPase+SbcC<-RNA-Helicase+A18	bacteria>firmicutes	5
<-SIG+TM(s)<-SIG+TM(s)<-PspC*	bacteria>other unclassified bacteria	5
<-SIG+TM||?->?-><-PspC*<-?<-RnaseT2	bacteria>other unclassified bacteria	5
<-TM(s)+IIGP1<-CR-ATPase1<-SIG+RHOD-CDC25<-Phageshock_PspD<-PspC*<-PspB<-PspA	bacteria>proteobacteria>gammaproteobacteria	5
ABC-ATPase->?->?-><-SIG+TM(s)<-?||CHTH+DSBH-><-PspC*	bacteria>firmicutes	5
Cluster110_2clades->PspC*->?->Cluster110_2clades-><-?||sGTP->	bacteria>actinobacteria	5
PADR-HTH->DUF1700-alpha-helical+TM(s)->SIG+Toast-rack->PspC*->	bacteria>firmicutes	5
PADR-HTH->PspC+LiaI-LiaF-TM+Toast-rack*->	bacteria>fcb group	5
PADR-HTH->Toast-rack->PspC*-><-?||?-><-SIG+TM(s)<-ABC-ATPase	bacteria>firmicutes	5
PspA->PspB->PspC*->?->CR-ATPase1->TM(s)+IIGP1->	bacteria>proteobacteria>gammaproteobacteria	5
PspA->PspB->PspC*->Phageshock_PspD->CR-ATPase1->TM(s)+IIGP1->NtrC-AAA+FIS-HTH-><-?||Cluster65_2clades->	bacteria>proteobacteria>gammaproteobacteria	5
PspA->PspC*->PspA->	bacteria>firmicutes	5
PspC*-><-Cluster85_4clades	bacteria>other unclassified bacteria	5
PspC*->SIG+TM(s)->	bacteria>firmicutes	5
PspC+LiaI-LiaF-TM(s)*->	bacteria>fcb group	5
PspC+TM(s)+HISKIN*->REC+LuxR-HTH->	bacteria>actinobacteria	5
REC+LuxR-HTH->SIG+HAMP+HISKIN->?->?->PspC*-><-?<-?||?-><-MODE-HTH+PBPII	bacteria>actinobacteria	5
SIG+PspC*->	bacteria>other unclassified bacteria	5
SIG+TM(s)-><-SIG+TM(s)<-PspC*<-Toast-rack	bacteria>firmicutes	5
Toast-rack->PspC*->SIG+TM(s)->SIG+LTD+IG+Calcineurin-><-GNTR-HTH+UTRA	bacteria>firmicutes	5
<-Cluster131_2clades<-SIG+TM(s)<-SIG+Toast-rack<-DUF1700-alpha-helical+TM(s)<-PADR-HTH||PspC*->	bacteria>firmicutes	4
<-Cluster187_2clades||tRNA->PspC*->	bacteria>firmicutes	4
<-Cluster65_2clades||?-><-NtrC-AAA+FIS-HTH<-TM(s)+IIGP1<-CR-ATPase1<-SIG+RHOD-CDC25<-Phageshock_PspD<-PspC*<-PspB<-PspA	bacteria>proteobacteria>gammaproteobacteria	4
<-DUF1700-alpha-helical+PspC+LiaI-LiaF-TM*<-PADR-HTH	bacteria>other unclassified bacteria	4
<-DUF1700-alpha-helical+PspC+TM(s)+Toast-rack*<-PADR-HTH	bacteria>fcb group	4
<-HEPN<-Cluster327_2clades||?-><-?||ABhydrolase-><-?<-PspC+TM(s)+Toast-rack*<-?<-?||PspC+TM(s)+HISKIN*->REC+LuxR-HTH-><-SIG+TM(s)||MODE-HTH+PBPII->	bacteria>actinobacteria	4
<-LiaI-LiaF-TM+Toast-rack<-PspC+LiaI-LiaF-TM*<-?<-ABC-ATPase	bacteria>other unclassified bacteria	4
<-MODE-HTH+PBPII<-?<-PspC*	bacteria>firmicutes	4
<-PspC*	NA	4
<-PspC*<-?<-?<-?<-sf+TM(s)	bacteria>proteobacteria>gammaproteobacteria	4
<-PspC*<-?<-Toast-rack<-PADR-HTH	bacteria>firmicutes	4
<-PspC*<-Cluster303_2clades	bacteria>firmicutes	4
<-PspC*<-HxxxH	bacteria>other unclassified bacteria	4
<-PspC*<-PspB<-PspA	bacteria>proteobacteria>deltaproteobacteria	4
<-PspC*<-PspC*<-Toast-rack	bacteria>firmicutes	4
<-PspC*<-SIG+Toast-rack<-DUF1700-alpha-helical+TM(s)<-PADR-HTH	bacteria>firmicutes	4
<-PspC*<-tRNA||Cluster187_2clades->	bacteria>firmicutes	4
<-PspC*||PhoD->	bacteria>actinobacteria	4
<-PspC*||PspC+TM(s)+HISKIN*->REC+LuxR-HTH->	bacteria>actinobacteria	4
<-PspC+LiaI-LiaF-TM*	archaea>euryarchaeota	4
<-PspC+TM(s)*||PspC+TM(s)+HISKIN*->REC+LuxR-HTH-><-MACRODOMAIN	bacteria>actinobacteria	4
<-REC+LuxR-HTH<-PspC+TM(s)+HISKIN*||PspC+TM(s)+Toast-rack*->?->PspC*-><-ABhydrolase	bacteria>actinobacteria	4
<-REC+LuxR-HTH<-SIG+TM+MORC<-SIG+TM+Toast-rack<-PspA<-PspC*<-PspA	bacteria>firmicutes	4
<-REC+LuxR-HTH<-SIG+TM+MORC<-SIG+TM+Toast-rack<-PspA<-PspC*<-PspA<-?<-SIG+TM(s)	bacteria>firmicutes	4
<-SIG+TM(s)<-?||?-><-SIG+TM(s)||?-><-PspC*	bacteria>actinobacteria	4
ABC-ATPase->ABC-ATPase->?->PspC*->SIG+TM(s)->?->?->pPIWI->Cluster37_3clades->	bacteria>firmicutes	4
ABhydrolase-><-?<-PspC+TM(s)+Toast-rack*||PspC+TM(s)+HISKIN*->REC+LuxR-HTH->	bacteria>actinobacteria	4
ABhydrolase-><-?<-PspC+TM(s)+Toast-rack*||PspC+TM(s)+HISKIN*->REC+LuxR-HTH->SIG+TM(s)->	bacteria>actinobacteria	4
Cluster221_3clades->?->PspC*->	bacteria>actinobacteria	4
Cluster368_2clades->PspC*->GNTR-HTH->ABC-ATPase->	bacteria>proteobacteria>gammaproteobacteria	4
Cluster374_3clades->DHH->PSYN->Cluster337_2clades->?->PspC+LiaI-LiaF-TM*->LiaI-LiaF-TM+Toast-rack->	bacteria>firmicutes	4
CS-><-PspC*	bacteria>other unclassified bacteria	4
DEAM->?->?-><-PspC*	bacteria>other unclassified bacteria	4
DEAM-><-?||?->?->PspC*->	archaea>euryarchaeota	4
MODE-HTH+PBPII-><-?||?->?-><-PspC*<-?<-?<-SIG+HAMP+HISKIN<-REC+LuxR-HTH	bacteria>actinobacteria	4
MuB-ATPase-><-?<-SIG+TM(s)<-?||?->ComEA-HHH+S1->?->PspC*->	bacteria>firmicutes	4
PADR-HTH->PspC+LiaI-LiaF-TM+Toast-rack*->	bacteria>other unclassified bacteria	4
PspA->PspB->PspC*->	NA	4
PspA->PspB->PspC*->Phageshock_PspD->CR-ATPase1->TM(s)+IIGP1->	NA	4
PspC*-><-SIG+CW-binding-EndolysinC<-REC+LuxR-HTH	bacteria>actinobacteria	4
PspC+TM(s)+HISKIN*->REC+LuxR-HTH-><-MACRODOMAIN	bacteria>actinobacteria	4
PspC+TM(s)+Toast-rack*->	bacteria>actinobacteria	4
RNA-Helicase->PspC*->	archaea>euryarchaeota	4
sGTP-><-PspC*	bacteria>firmicutes	4
SIGMA-HTH->?->?->PspC*->PspC+LiaI-LiaF-TM*->7TMR-HDED->7TMR-HDED->	bacteria>other unclassified bacteria	4
<-Cluster186_3clades<-PspC*	bacteria>acidobacteria	3
<-Cluster39_2clades<-?<-PspC*<-PspB<-PspA	bacteria>proteobacteria>alphaproteobacteria	3
<-Cluster65_2clades<-SIG+Toast-rack<-DUF1700-alpha-helical+PspC+LiaI-LiaF-TM+Toast-rack*<-PADR-HTH	bacteria>fcb group	3
<-Cluster66_1clades*	bacteria>proteobacteria>gammaproteobacteria	3
<-Cluster73_4clades<-SIG+TM(s)<-?<-SIG+TM(s)<-?||ComEA-HHH+S1->?->PspC*->	bacteria>firmicutes	3
<-Cluster81_2clades<-?<-SIG+TM(s)<-?<-PspC*<-?<-SIG+RHOD-CDC25	bacteria>fcb group	3
<-DUF1700-alpha-helical+PspC+LiaI-LiaF-TM*<-PADR-HTH||?->SIG+TM(s)->	bacteria>other unclassified bacteria	3
<-NtrC-AAA+FIS-HTH<-?<-ELM2<-STAT<-TM(s)+IIGP1<-CR-ATPase1<-PspC*<-PspB<-PspA	bacteria>proteobacteria>gammaproteobacteria	3
<-PspC*	bacteria>chloroflexi	3
<-PspC*<-?<-ComEA-HHH+S1||?->SIG+TM(s)->?->SIG+TM(s)->Cluster73_4clades->	bacteria>firmicutes	3
<-PspC*<-Cluster85_4clades<-?<-Cluster87_3clades<-?<-?<-RNA-Helicase	bacteria>other unclassified bacteria	3
<-PspC*<-PspB	bacteria>proteobacteria>gammaproteobacteria	3
<-PspC+LiaI-LiaF-TM+Toast-rack*<-PADR-HTH	bacteria>fcb group	3
<-PspC+TM(s)+Toast-rack*<-PADR-HTH	bacteria>fcb group	3
<-PspC+TM(s)+Toast-rack*||PspC+TM(s)+HISKIN*->	bacteria>actinobacteria	3
<-PSYN<-SIG+TM(s)<-?<-SIG+TM(s)<-?||PspC*-><-FKBP<-RADICAL-SAM+TRAM	bacteria>fcb group	3
<-REC+LuxR-HTH<-PspC+TM(s)+HISKIN*<-?||PspC+TM(s)+Toast-rack*->	bacteria>actinobacteria	3
<-REC+LuxR-HTH<-PspC+TM(s)+HISKIN*||PspC+TM(s)+Toast-rack*->?-><-?<-ABhydrolase	bacteria>actinobacteria	3
<-REC+LuxR-HTH<-SIG+TM+MORC<-SIG+TM+Toast-rack<-PspA<-PspC*<-PspA<-?<-SIG+TM(s)<-TetR-HTH	bacteria>firmicutes	3
<-SIG+HAMP+HISKIN<-REC+LuxR-HTH||?-><-PspC*<-?<-?<-REC+LuxR-HTH||?-><-?<-?<-Cluster87_3clades	bacteria>other unclassified bacteria	3
<-SIG+TM(s)+FTSK(s)-HTH<-?<-?<-?<-?<-PspC*	bacteria>other unclassified bacteria	3
<-SIG+TM(s)<-Cluster134_2clades<-ABC-ATPase<-ABC-ATPase<-SIG+TM(s)<-?<-Cluster73_4clades||PspC+LiaI-LiaF-TM*->LiaI-LiaF-TM+Toast-rack->	bacteria>thermotogae	3
<-SIG+TM(s)<-PspC*<-Toast-rack<-SbcC(s)+ABC-ATPase+SbcC<-RNA-Helicase+A18	bacteria>firmicutes	3
<-SIG+Toast-rack<-DUF1700-alpha-helical+PspC+LiaI-LiaF-TM+Toast-rack*<-PADR-HTH	bacteria>fcb group	3
<-TM(s)+IIGP1<-CR-ATPase1<-Phageshock_PspD<-PspC*<-PspB<-PspA	NA	3
<-TM<-Cluster37_3clades<-pPIWI<-?<-?<-SIG+TM(s)<-PspC*<-?<-ABC-ATPase<-ABC-ATPase	bacteria>firmicutes	3
<-TM<-Cluster87_3clades<-?<-?<-?<-SIG+TM(s)<-PspC*	bacteria>firmicutes	3
<-TM||sf+TM(s)->?->?->PspC*->	NA	3
A18->Cluster95_4clades->PspC*->SIG+TM(s)->?->?->pPIWI->Cluster37_3clades->	bacteria>firmicutes	3
ABC-ATPase->ABC-ATPase->?->PspC*->SIG+TM(s)->?->?->pPIWI->Cluster37_3clades->TM->	bacteria>firmicutes	3
ABhydrolase-><-?<-PspC+TM(s)+Toast-rack*||PspC+TM(s)+HISKIN*->	bacteria>actinobacteria	3
ABhydrolase-><-PspC*	bacteria>actinobacteria	3
Cluster236_2clades->Cluster234_2clades->?->?-><-?||Cluster469_2clades->PspC*->	bacteria>other unclassified bacteria	3
Cluster81_2clades->?-><-PspC*	bacteria>actinobacteria	3
Cluster87_3clades->PspC*-><-?<-?||sGTP->	bacteria>other unclassified bacteria	3
ENOYCOADEHYD-><-?<-PspC*	bacteria>proteobacteria>gammaproteobacteria	3
LRP-HTH->?->PspC+LiaI-LiaF-TM*->SIG+TM(s)+Toast-rack->?-><-?<-?||RADICAL-SAM->	archaea>euryarchaeota	3
PADR-HTH->DUF1700-alpha-helical+PspC+LiaI-LiaF-TM+Toast-rack*->?->SIG+Toast-rack->	bacteria>fcb group	3
PADR-HTH->DUF1700-alpha-helical+PspC+LiaI-LiaF-TM+Toast-rack*->SIG+Toast-rack->Cluster65_2clades->?->?-><-TM	bacteria>fcb group	3
PADR-HTH->DUF1700-alpha-helical+PspC+LiaI-LiaF-TM+Toast-rack*->SIG+Toast-rack->SIG+Toast-rack->	bacteria>fcb group	3
PADR-HTH->PspC(s)+LiaI-LiaF-TM+Toast-rack(s)*->	bacteria>fcb group	3
PADR-HTH->PspC(s)+LiaI-LiaF-TM+Toast-rack*->	bacteria>fcb group	3
PspA->PspB->PspC*->	bacteria>proteobacteria>deltaproteobacteria	3
PspA->PspB->PspC*->?->?->?->?->?->Cluster39_2clades->	bacteria>proteobacteria>alphaproteobacteria	3
PspA->PspB->PspC*->?->?->?->?->Cluster39_2clades->	bacteria>proteobacteria>alphaproteobacteria	3
PspC*->?-><-ENOYCOADEHYD	bacteria>proteobacteria>gammaproteobacteria	3
PspC*-><-TM<-NUDIX<-?<-?<-Cluster229_2clades	bacteria>proteobacteria>alphaproteobacteria	3
PspC*->PSE->?->?->SIG+GDSL->?-><-?||SIGMA-HTH->	bacteria>other unclassified bacteria	3
PspC*->SIG+TM(s)->?->?->pPIWI->Cluster37_3clades->	bacteria>firmicutes	3
PspC*->SIG+TM(s)->?->?->pPIWI->Cluster37_3clades->TM->	bacteria>firmicutes	3
PspC*->SIG+TM(s)->?->?->pPIWI->TM->	bacteria>firmicutes	3
PspC+LiaI-LiaF-TM*->?->CHC2+Toprim-DNAG->	bacteria>other unclassified bacteria	3
PspC+LiaI-LiaF-TM*->LiaI-LiaF-TM+Toast-rack->	bacteria>fcb group	3
PspC+TM*->	bacteria>firmicutes	3
REC+LuxR-HTH->SIG+HAMP+HISKIN->?->?->PspC*->	bacteria>actinobacteria	3
SIG+TM(s)*->	bacteria>firmicutes	3
SIG+TM*->	bacteria>proteobacteria>gammaproteobacteria	3
SIG+TM+PspC*->	bacteria>cyanobacteria	3
TM->PspC+LiaI-LiaF-TM*->LiaI-LiaF-TM+Toast-rack->	bacteria>fcb group	3
TM(s)->PspC*-><-?<-?<-HxxxH	bacteria>firmicutes	3
<-35exo<-?<-SIGMA-HTH<-?<-?||TM(s)-><-PspC+LiaI-LiaF-TM*	bacteria>firmicutes	2
<-7TMR-HDED<-7TMR-HDED<-PspC+LiaI-LiaF-TM*<-PspC*<-?<-?<-SIGMA-HTH	bacteria>other unclassified bacteria	2
<-A18<-?<-SGS<-?<-ABC-ATPase<-PspC+TM(s)+Toast-rack*<-PADR-HTH	bacteria>other unclassified bacteria	2
<-A18||PspC+LiaI-LiaF-TM*->	bacteria>other unclassified bacteria	2
<-Cluster193_3clades<-Cluster193_3clades||SIG+TM(s)-><-PspC*	bacteria>other unclassified bacteria	2
<-Cluster293_2clades<-?<-Cluster81_2clades<-?<-SIG+TM(s)<-?<-PspC*<-?<-SIG+RHOD-CDC25	bacteria>fcb group	2
<-Cluster320_2clades<-PspC*	bacteria>proteobacteria>deltaproteobacteria	2
<-Cluster37_3clades<-pPIWI<-?<-?<-SIG+TM(s)<-PspC*<-?<-ABC-ATPase<-ABC-ATPase	bacteria>firmicutes	2
<-Cluster372_2clades||PspC*->	bacteria>other unclassified bacteria	2
<-Cluster81_2clades<-?<-SIG+TM(s)<-?<-PspC*	bacteria>fcb group	2
<-DUF1700-alpha-helical+PspC(s)+LiaI-LiaF-TM+Toast-rack*<-PADR-HTH	bacteria>fcb group	2
<-HMA+TM(s)<-?<-SIG+TM(s)+FTSK(s)-HTH<-PspC*	bacteria>firmicutes	2
<-LiaI-LiaF-TM+Toast-rack<-PspC+LiaI-LiaF-TM*	bacteria>fcb group	2
<-MODE-HTH+PBPII||SIG+TM(s)->?-><-?<-REC+LuxR-HTH<-PspC+TM(s)+HISKIN*||PspC+TM(s)+Toast-rack*->	bacteria>actinobacteria	2
<-MODE-HTH+PBPII||SIG+TM(s)-><-REC+LuxR-HTH<-PspC+TM(s)+HISKIN*	bacteria>actinobacteria	2
<-NtrC-AAA+FIS-HTH<-TM(s)+IIGP1<-CR-ATPase1<-Phageshock_PspD<-PspC*<-PspB<-PspA	bacteria>proteobacteria>gammaproteobacteria	2
<-NtrC-AAA+FIS-HTH<-TM(s)+IIGP1<-CR-ATPase1<-Phageshock_PspD<-PspC*<-PspB<-PspA||NtrC-AAA+FIS-HTH->	bacteria>proteobacteria>gammaproteobacteria	2
<-NtrC-AAA+FIS-HTH||PspA->?->SIG+Toast-rack->SIG+Toast-rack*->SIG+TM(s)->ABC-ATPase->	bacteria>proteobacteria>alphaproteobacteria	2
<-PspC*	archaea>dpann group	2
<-PspC*	bacteria>fusobacteria	2
<-PspC*<-?<-?<-?<-sf+TM(s)||TM->	bacteria>proteobacteria>gammaproteobacteria	2
<-PspC*<-?<-?<-Cluster144_2clades<-SIGMA-HTH<-CHC2+Toprim-DNAG	bacteria>firmicutes	2
<-PspC*<-?<-?<-Cluster144_2clades<-SIGMA-HTH<-CHC2+Toprim-DNAG<-ABC-ATPase	bacteria>firmicutes	2
<-PspC*<-?<-?<-sf+TM(s)<-NUDIX	bacteria>proteobacteria>gammaproteobacteria	2
<-PspC*<-?<-?<-sf+TM(s)||TM->	NA	2
<-PspC*<-?<-?||?-><-DEAM	archaea>euryarchaeota	2
<-PspC*<-?<-ComEA-HHH+S1||?->SIG+TM(s)->	bacteria>firmicutes	2
<-PspC*<-?<-PspC+TM(s)+Toast-rack*||PspC+TM(s)+HISKIN*->REC+LuxR-HTH-><-Cluster115_3clades	bacteria>actinobacteria	2
<-PspC*<-?||?-><-Cluster531_2clades||Cluster688_2clades->	bacteria>proteobacteria>deltaproteobacteria	2
<-PspC*<-?||QTG-><-?<-?<-HMA+TM(s)<-?||HhH-RADC+JAB->	bacteria>other unclassified bacteria	2
<-PspC*<-Cluster85_4clades	bacteria>other unclassified bacteria	2
<-PspC*<-PspA	bacteria>proteobacteria>alphaproteobacteria	2
<-PspC*<-REC+LuxR-HTH	bacteria>other unclassified bacteria	2
<-PspC*<-SIG+TM(s)<-?<-SIG+TM(s)	archaea>euryarchaeota	2
<-PspC*<-Toast-rack<-?<-ComEA-HHH+S1	bacteria>firmicutes	2
<-PspC*<-Toast-rack<-PADR-HTH	bacteria>firmicutes	2
<-PspC*||?->?->EMAP->	bacteria>firmicutes	2
<-PspC*||Cluster81_2clades->	bacteria>actinobacteria	2
<-PspC*||ncRNA-><-SIG+TM(s)<-?<-?<-?<-ABC-ATPase	bacteria>other unclassified bacteria	2
<-PspC+TM(s)+Toast-rack*||?->PspC+TM(s)+HISKIN*->REC+LuxR-HTH->	bacteria>actinobacteria	2
<-PspC+TM(s)+Toast-rack*||PspC+TM(s)+HISKIN*->REC+LuxR-HTH-><-?||?->?-><-?||?-><-TM(s)	bacteria>actinobacteria	2
<-RADICAL-SAM||?->?-><-?<-SIG+TM(s)+Toast-rack<-PspC+LiaI-LiaF-TM*<-PspC*	archaea>euryarchaeota	2
<-REC+LuxR-HTH<-PspC+TM(s)+HISKIN*||PspC+TM(s)*->?-><-?<-SIG+TM(s)+ABC-ATPase<-SIG+TM(s)+ABC-ATPase	bacteria>actinobacteria	2
<-REC+LuxR-HTH<-PspC+TM(s)+HISKIN*||PspC+TM(s)+Toast-rack*->?->?-><-?<-?<-?||PspC*-><-ABhydrolase	bacteria>actinobacteria	2
<-REC+LuxR-HTH<-PspC+TM(s)+HISKIN*||PspC+TM(s)+Toast-rack*->?-><-ABhydrolase	NA	2
<-REC+LuxR-HTH<-PspC+TM(s)+HISKIN*||PspC+TM(s)+Toast-rack*->?->ABC-ATPase->SIG+TM(s)->	bacteria>actinobacteria	2
<-REC+LuxR-HTH<-PspC+TM(s)+HISKIN*||PspC+TM(s)+Toast-rack*-><-?<-ABhydrolase	bacteria>actinobacteria	2
<-REC+LuxR-HTH<-PspC+TM(s)+HISKIN*||SIG+PspC+TM*->	bacteria>actinobacteria	2
<-SbcC(s)+ABC-ATPase+SbcC<-RNA-Helicase+A18<-Cluster215_2clades<-?<-?<-SIG+TM(s)<-PspC*<-SIG+HAMP+HISKIN<-REC+LuxR-HTH	bacteria>firmicutes	2
<-SIG+TM(s)<-PspC*<-Toast-rack<-?<-ABC-ATPase<-ABC-ATPase	bacteria>firmicutes	2
<-SIG+TM(s)||?-><-?||ComEA-HHH+S1->?->PspC*->	bacteria>firmicutes	2
<-SIG+TM+PspC*	bacteria>cyanobacteria	2
<-SIG+Toast-rack<-?<-SIG+Toast-rack<-DUF1700-alpha-helical+PspC+LiaI-LiaF-TM+Toast-rack*<-PADR-HTH<-SIG+Toast-rack	bacteria>fcb group	2
<-SIG+Toast-rack<-SIG+Toast-rack<-DUF1700-alpha-helical+PspC+LiaI-LiaF-TM+Toast-rack*<-PADR-HTH	bacteria>fcb group	2
<-SIGMA-HTH<-CHC2+Toprim-DNAG<-?<-PspC+LiaI-LiaF-TM*	bacteria>other unclassified bacteria	2
<-TM(s)+IIGP1<-CR-ATPase1<-Phageshock_PspD<-PspC*<-PspB	NA	2
ABC-ATPase->?-><-?<-?||?->PspC+LiaI-LiaF-TM*-><-TM(s)	bacteria>firmicutes	2
ABC-ATPase->?->PspC+LiaI-LiaF-TM*->LiaI-LiaF-TM+Toast-rack->	bacteria>other unclassified bacteria	2
ABC-ATPase->CHC2+Toprim-DNAG->SIGMA-HTH->Cluster144_2clades->?->?->PspC*->	bacteria>firmicutes	2
ABC-ATPase->SIG+TM(s)->PspC*->	bacteria>other unclassified bacteria	2
ABhydrolase->?->?->?-><-?<-PspC+TM(s)+Toast-rack*||PspC+TM(s)+HISKIN*->REC+LuxR-HTH->	bacteria>actinobacteria	2
ABhydrolase->?-><-?<-PspC+TM(s)+Toast-rack*||PspC+TM(s)+HISKIN*->REC+LuxR-HTH->	bacteria>actinobacteria	2
ABhydrolase-><-?||?-><-PspC+TM(s)+Toast-rack*||PspC+TM(s)+HISKIN*->REC+LuxR-HTH->	bacteria>actinobacteria	2
ArgR-HTH->?->?->PspC*->?->Cluster283_3clades->	bacteria>fcb group	2
ArgR-HTH-><-?<-?<-?<-PspC*<-?<-?<-Cluster144_2clades<-SIGMA-HTH<-CHC2+Toprim-DNAG	bacteria>firmicutes	2
CHC2+Toprim-DNAG->SIGMA-HTH->Cluster144_2clades->?->?->PspC*->?->?->?-><-ArgR-HTH	bacteria>firmicutes	2
Cluster110_2clades->PspC*->?->Cluster110_2clades-><-?||sGTP->	NA	2
Cluster115_3clades-><-REC+LuxR-HTH<-PspC+TM(s)+HISKIN*||PspC+TM(s)+Toast-rack*->?->PspC*->	bacteria>actinobacteria	2
Cluster115_3clades->PspC*->SMS-KaiC->?-><-SIG+TM(s)<-?<-?<-Cluster722_2clades	bacteria>firmicutes	2
Cluster166_3clades-><-?<-?<-?<-HMA+TM(s)<-?||PspC*->	bacteria>other unclassified bacteria	2
Cluster166_3clades-><-?<-?<-?<-HMA+TM(s)<-?||PspC*->LiaI-LiaF-TM+Toast-rack->	bacteria>other unclassified bacteria	2
Cluster212_2clades->BLBD->Cluster185_3clades-><-TM*<-PspB<-PspA	bacteria>proteobacteria>alphaproteobacteria	2
Cluster212_2clades->BLBD->PspC*->Cluster185_3clades->	bacteria>proteobacteria>betaproteobacteria	2
Cluster229_2clades->?->?->NUDIX->TM-><-PspC*	bacteria>proteobacteria>alphaproteobacteria	2
Cluster236_2clades->Cluster234_2clades->?-><-SUA<-PspC+LiaI-LiaF-TM*<-?||HhH-GPD-><-PSYN<-Cluster335_2clades	bacteria>other unclassified bacteria	2
Cluster287_4clades->?->?->?->Cluster559_2clades->?->?->PspC*->	bacteria>firmicutes	2
Cluster293_2clades->?->?-><-PELOTA<-?<-?<-PspC*<-Cluster470_2clades	bacteria>other unclassified bacteria	2
Cluster303_2clades->PspC*->	bacteria>firmicutes	2
Cluster547_2clades-><-?<-PspC*	bacteria>other unclassified bacteria	2
Cluster594_2clades->PspC*->SIG+TM(s)->	bacteria>firmicutes	2
Cluster771_2clades->?->?->?->Cluster733_2clades->?-><-PspA<-PspC*	bacteria>firmicutes	2
Cluster85_4clades->PspC*->	bacteria>other unclassified bacteria	2
Cluster95_4clades->PspC*->SIG+TM(s)->?->?->pPIWI->Cluster37_3clades-><-?<-Ferredoxin-RRM	bacteria>firmicutes	2
Ferredoxin-RRM->?-><-Cluster37_3clades<-pPIWI<-?<-?<-SIG+TM(s)<-PspC*<-Cluster95_4clades	bacteria>firmicutes	2
HTH->?->?-><-PspC*<-Cluster364_3clades	archaea>dpann group	2
HTH->?->?-><-PspC*<-HxxxH||?->?->RnaseIII->	bacteria>other unclassified bacteria	2
InPase->?->?-><-?<-?||?->PspC*->	bacteria>other unclassified bacteria	2
MODE-HTH+PBPII-><-?<-?<-?||?->PADR-HTH->DUF1700-alpha-helical+PspC+LiaI-LiaF-TM+Toast-rack*->	bacteria>fcb group	2
MuB-ATPase-><-?<-?<-PspC*	archaea>euryarchaeota	2
PADR-HTH->DUF1700-alpha-helical+PspC(s)+LiaI-LiaF-TM+Toast-rack*->	bacteria>fcb group	2
PADR-HTH->DUF1700-alpha-helical+PspC+LiaI-LiaF-TM+Toast-rack*->SIG+Toast-rack->SIG+Toast-rack-><-TM	bacteria>fcb group	2
PADR-HTH->PspC+TM(s)+Toast-rack*->?->ABC-ATPase->?-><-?||SGS->?->A18->	bacteria>other unclassified bacteria	2
PADR-HTH->Toast-rack->PspC*-><-PELOTA<-?<-SbcC(s)<-?<-Cluster753_2clades	bacteria>firmicutes	2
PspA->PspB->PspC*->?->?->?->Cluster39_2clades->	bacteria>proteobacteria>alphaproteobacteria	2
PspA->PspB->PspC*->Cluster131_2clades-><-STAT<-SIG+PhospholipaseD(s)	bacteria>proteobacteria>gammaproteobacteria	2
PspA->PspB->PspC*->CR-ATPase1->TM(s)+IIGP1->STAT->	bacteria>proteobacteria>gammaproteobacteria	2
PspA->PspB->PspC*->Phageshock_PspD->CR-ATPase1->TM(s)+IIGP1->NtrC-AAA+FIS-HTH->	bacteria>proteobacteria>gammaproteobacteria	2
PspA->PspB->PspC*->Phageshock_PspD->SIG+RHOD-CDC25->?->?->?->SIG+TM(s)->SIG+TM(s)->	NA	2
PspA->PspB->PspC*->Phageshock_PspD->SIG+RHOD-CDC25->CR-ATPase1->TM(s)+IIGP1->NtrC-AAA+FIS-HTH-><-?||Cluster65_2clades->	bacteria>proteobacteria>gammaproteobacteria	2
PspA->PspC*->?-><-ENOYCOADEHYD	bacteria>proteobacteria>gammaproteobacteria	2
PspC*->	archaea>dpann group	2
PspC*->	bacteria>acidobacteria	2
PspC*->	bacteria>proteobacteria>deltaproteobacteria	2
PspC*->	NA	2
PspC*->?->ABC-ATPase->SIG+TM(s)->	bacteria>other unclassified bacteria	2
PspC*->?->Cluster531_2clades->	bacteria>firmicutes	2
PspC*->?->SIG+TM->?->SIG+Tox-TGase->	bacteria>other unclassified bacteria	2
PspC*-><-?<-?<-?<-ABC-ATPase<-NUDIX	bacteria>firmicutes	2
PspC*-><-?||DEOR-HTH+WYL(s)-C->	bacteria>actinobacteria	2
PspC*-><-Cluster398_2clades	bacteria>actinobacteria	2
PspC*-><-tRNA<-?<-Ferredoxin-RRM	bacteria>actinobacteria	2
PspC*->Cluster320_2clades->	bacteria>proteobacteria>deltaproteobacteria	2
PspC*->Cluster364_3clades->	bacteria>firmicutes	2
PspC*->Cluster633_3clades->	bacteria>other unclassified bacteria	2
PspC*->ISOCOT->?->PELOTA->	bacteria>proteobacteria>gammaproteobacteria	2
PspC*->O6MGT-HTH->Cluster786_2clades->	bacteria>firmicutes	2
PspC*->PspC*->	bacteria>firmicutes	2
PspC*->SIG+TM(s)+FTSK(s)-HTH->	bacteria>firmicutes	2
PspC*->SMS-KaiC->	bacteria>other unclassified bacteria	2
PspC+LiaI-LiaF-TM*->	archaea>euryarchaeota	2
PspC+LiaI-LiaF-TM*->	bacteria>chloroflexi	2
PspC+LiaI-LiaF-TM*-><-TM(s)||?->?->SIGMA-HTH->?->35exo->	bacteria>firmicutes	2
PspC+TM(s)+Toast-rack*->?->?-><-?<-?<-?||PspC*-><-ABhydrolase	bacteria>actinobacteria	2
RADICAL-SAM+TRAM->FKBP-><-PspC*||?->SIG+TM(s)->?->SIG+TM(s)->PSYN->	bacteria>fcb group	2
RADICAL-SAM+TRAM->MuB-ATPase->ncRNA->?-><-?<-Cluster39_2clades<-?<-PspC*<-PspB<-PspA	bacteria>proteobacteria>alphaproteobacteria	2
REC+LuxR-HTH->SIG+HAMP+HISKIN->PspC*->SIG+TM(s)->?->?->Cluster215_2clades->RNA-Helicase+A18->SbcC(s)+ABC-ATPase+SbcC->	bacteria>firmicutes	2
SbcC(s)+ABC-ATPase+SbcC->?->?-><-?||PADR-HTH->DUF1700-alpha-helical+PspC+LiaI-LiaF-TM*->	bacteria>fcb group	2
sf+TM(s)-><-?<-?<-PspC+TM(s)+Toast-rack*||PspC+TM(s)+HISKIN*->REC+LuxR-HTH->	bacteria>actinobacteria	2
sGTP->PspC*-><-?||?->sGTP->	bacteria>other unclassified bacteria	2
SIG+PhospholipaseD(s)->STAT-><-Cluster131_2clades<-PspC*<-PspB<-PspA||NtrC-AAA+FIS-HTH->Cluster134_2clades->SIG+TM(s)->SIG+TM(s)->ABC-ATPase->	bacteria>proteobacteria>gammaproteobacteria	2
SIG+TM(s)->?->PspC*->	bacteria>fcb group	2
SIG+TM(s)-><-TM||PspC*-><-?<-tRNA<-MODE-HTH+PBPII	bacteria>actinobacteria	2
SIG+TM(s)->PADR-HTH->PspC+LiaI-LiaF-TM+Toast-rack*->	bacteria>other unclassified bacteria	2
SIG+TM(s)+ABC-ATPase->?-><-PspC+LiaI-LiaF-TM*||A18->	bacteria>other unclassified bacteria	2
TM->Cluster749_2clades-><-?<-?<-ABC-ATPase<-?<-LiaI-LiaF-TM+Toast-rack<-PspC+LiaI-LiaF-TM*	bacteria>thermotogae	2
TM(s)->SIG+TM(s)+CBS->PspC+TM(s)+LiaI-LiaF-TM*->	bacteria>actinobacteria	2
Toast-rack->PspC*->?->SIG+TM(s)->	bacteria>firmicutes	2
<-A18<-?<-?<-?<-?<-SGS<-?<-PSE<-PspC+TM(s)+Toast-rack*<-PADR-HTH<-?<-Cluster303_2clades	bacteria>other unclassified bacteria	1
<-A18<-?<-SGS<-?<-PSE<-ABC-ATPase<-PspC+TM(s)+Toast-rack*<-PADR-HTH	bacteria>other unclassified bacteria	1
<-A18||?->PspC+LiaI-LiaF-TM*->?->?-><-?<-?<-?||?->HhH-GPD->	bacteria>other unclassified bacteria	1
<-A18||PspC+LiaI-LiaF-TM*-><-?<-SIG+TM(s)+ABC-ATPase	bacteria>other unclassified bacteria	1
<-ABC-ATPase<-?<-PspC*	bacteria>other unclassified bacteria	1
<-ABC-ATPase<-?<-PspC+LiaI-LiaF-TM*	bacteria>other unclassified bacteria	1
<-ABC-ATPase<-?<-PspC+LiaI-LiaF-TM+Toast-rack*	bacteria>other unclassified bacteria	1
<-ABC-ATPase<-?<-PspC+TM*	bacteria>firmicutes	1
<-ABC-ATPase<-GNTR-HTH<-PspC*<-Cluster368_2clades	bacteria>proteobacteria>gammaproteobacteria	1
<-ABC-ATPase<-REC+LuxR-HTH<-?<-PspC*	bacteria>actinobacteria	1
<-ABC-ATPase<-SIG+TM(s)<-PspC+TM(s)+Toast-rack*<-SIG+Toast-rack<-?<-PspA||NtrC-AAA+FIS-HTH->	bacteria>proteobacteria>alphaproteobacteria	1
<-ABC-ATPase<-SIG+TM(s)||TM->PspC+LiaI-LiaF-TM*->LiaI-LiaF-TM+Toast-rack->	bacteria>fcb group	1
<-ABC-ATPase||SIG+GDSL-><-SbcC(s)<-NtrC-AAA+FIS-HTH||?->PspA->PspB->PspC*->?->?->?->?->?->Cluster39_2clades->	bacteria>proteobacteria>alphaproteobacteria	1
<-ACT<-Cluster186_3clades<-SWIRM<-?<-?<-PspC*	bacteria>actinobacteria	1
<-CBS<-PspC+LiaI-LiaF-TM+Toast-rack*<-PADR-HTH	bacteria>fcb group	1
<-Cluster1000_2clades<-?<-?||METHYLASE-><-?<-SIG+Toast-rack<-SIG+Toast-rack<-DUF1700-alpha-helical+PspC+LiaI-LiaF-TM+Toast-rack*<-PADR-HTH	bacteria>fcb group	1
<-Cluster1034_2clades<-ELM2||LRP-HTH-><-NtrC-AAA+FIS-HTH||?->PspA->PspB->PspC*->?->?->Cluster39_2clades->?-><-Cluster278_2clades	bacteria>proteobacteria>alphaproteobacteria	1
<-Cluster1042_2clades<-SIG+CW-binding-EndolysinC<-DUF1700-alpha-helical+PspC+LiaI-LiaF-TM+Toast-rack*<-SIG+Toast-rack<-PADR-HTH<-PspC*<-PspC*	bacteria>fcb group	1
<-Cluster1049_2clades<-?||?->PspC*->	bacteria>actinobacteria	1
<-Cluster1058_2clades<-?||?->?->PspC*-><-MACRODOMAIN	bacteria>deinococcus-thermus	1
<-Cluster1111_2clades<-?<-?<-?<-PspC*<-SIG+Toast-rack<-DUF1700-alpha-helical+TM(s)<-PADR-HTH<-PspC*	bacteria>firmicutes	1
<-Cluster1115_2clades<-PspC*	bacteria>other unclassified bacteria	1
<-Cluster1115_2clades||?-><-?<-?<-PRTase||Cluster166_3clades-><-PspC*	bacteria>proteobacteria>alphaproteobacteria	1
<-Cluster131_2clades<-SIG+TM(s)<-SIG+BLBD<-SIG+BLBD<-PspC*<-PspB	bacteria>proteobacteria>gammaproteobacteria	1
<-Cluster185_3clades<-PspC*<-BLBD<-Cluster212_2clades	bacteria>proteobacteria>betaproteobacteria	1
<-Cluster185_3clades<-PspC*<-BLBD<-Cluster212_2clades||?->?-><-?<-Cluster948_2clades<-SIR2	bacteria>proteobacteria>betaproteobacteria	1
<-Cluster193_3clades<-?||?->?->PADR-HTH->PspC+LiaI-LiaF-TM*-><-?<-SIG+TM(s)<-Cluster229_2clades<-PELOTA<-?<-?<-RnaseIII	bacteria>proteobacteria>alphaproteobacteria	1
<-Cluster193_3clades||SIG+TM(s)-><-PspC*	bacteria>other unclassified bacteria	1
<-Cluster215_2clades<-?||Cluster185_3clades->PspC*->	bacteria>actinobacteria	1
<-Cluster215_2clades<-TM<-Cluster37_3clades<-pPIWI<-?<-?<-SIG+TM(s)<-PspC*<-?<-?<-SbcC(s)+ABC-ATPase+SbcC	bacteria>firmicutes	1
<-Cluster290_3clades||SWIRM-><-?||?->?-><-?<-PspC+LiaI-LiaF-TM*	bacteria>other unclassified bacteria	1
<-Cluster293_2clades<-?<-Cluster81_2clades<-?<-SIG+TM(s)<-?<-PspC*	bacteria>fcb group	1
<-Cluster293_2clades<-Cluster81_2clades<-?<-SIG+TM(s)<-?<-PspC*<-?<-Cluster773_2clades	bacteria>fcb group	1
<-Cluster320_2clades<-?<-?<-?<-?<-PspC*<-UbE1<-?<-PSE<-?<-PSE<-HEPN	bacteria>other unclassified bacteria	1
<-Cluster357_4clades<-PspC*||?->Cluster37_3clades->	bacteria>pvc group	1
<-Cluster357_4clades||?-><-?||S2P+TM(s)-><-?||?->?->PspC*->?->?->sGTP->	bacteria>other unclassified bacteria	1
<-Cluster37_3clades<-?||PspC*->Cluster357_4clades->?-><-?||SIG+NarQ+PhospholipaseD->	bacteria>pvc group	1
<-Cluster37_3clades<-pPIWI<-?<-?<-SIG+TM(s)<-PspC*	bacteria>firmicutes	1
<-Cluster37_3clades<-pPIWI<-?<-?<-SIG+TM(s)<-PspC*<-Cluster95_4clades	bacteria>firmicutes	1
<-Cluster37_3clades<-pPIWI<-?<-?<-SIG+TM(s)<-PspC*<-Cluster95_4clades<-A18	bacteria>firmicutes	1
<-Cluster372_2clades||?->?-><-?<-PspC+LiaI-LiaF-TM*<-SIG+TM(s)<-?<-SIG+TM(s)<-ABC-ATPase<-ABC-ATPase<-SIG+TM(s)	archaea>euryarchaeota	1
<-Cluster374_3clades<-?<-?<-?<-?<-?<-?||PspC*->	bacteria>proteobacteria>alphaproteobacteria	1
<-Cluster39_2clades<-?<-?<-?<-?<-?<-?<-PspC*<-PspB<-PspA	bacteria>proteobacteria>alphaproteobacteria	1
<-Cluster39_2clades<-?<-?<-?<-?<-?<-?<-PspC*<-PspB<-PspA<-?||NtrC-AAA+FIS-HTH->	bacteria>proteobacteria>alphaproteobacteria	1
<-Cluster39_2clades<-?<-?<-?<-?<-?<-PspC*<-PspB<-PspA<-?||NtrC-AAA+FIS-HTH->	bacteria>proteobacteria>alphaproteobacteria	1
<-Cluster398_2clades<-?||?->?->?->?-><-SIG+TM<-PspC*	bacteria>other unclassified bacteria	1
<-Cluster469_2clades<-?<-PspC*	archaea>euryarchaeota	1
<-Cluster547_2clades<-?||?-><-PspC*	bacteria>firmicutes	1
<-Cluster547_2clades||?-><-PspC*	bacteria>firmicutes	1
<-Cluster552_2clades||SIG+TM(s)-><-?<-RnaseT2<-Cluster287_4clades<-PspC+LiaI-LiaF-TM*<-?<-FKBP	bacteria>other unclassified bacteria	1
<-Cluster559_2clades<-?<-?<-?<-?||SIG+TM(s)-><-?<-PspC+LiaI-LiaF-TM*<-SIG+TM(s)+ABC-ATPase	bacteria>firmicutes	1
<-Cluster633_3clades<-PspC*	bacteria>thermobaculum	1
<-Cluster702_3clades||?-><-?<-?||Cluster1289_2clades-><-PspC*||PspC+TM(s)+HISKIN*->REC+LuxR-HTH->	bacteria>actinobacteria	1
<-Cluster73_4clades<-PspC*<-?<-DHH	bacteria>other unclassified bacteria	1
<-Cluster752_3clades<-?<-PspC+TM(s)+Toast-rack*<-PspC*||PspC+TM(s)+HISKIN->REC+LuxR-HTH->?-><-SIG+TM(s)	bacteria>actinobacteria	1
<-Cluster784_2clades<-PurD-ATPgrasp||?->PhoD-><-RNA-Helicase<-?<-REC+LuxR-HTH<-PspC+TM(s)+HISKIN*||?->PspC+TM(s)+Toast-rack*->?-><-?<-RnasePH(s)+KH+S1<-TET-JBP	bacteria>actinobacteria	1
<-Cluster786_2clades||?->PspC*->	bacteria>spirochaetes	1
<-Cluster85_4clades<-?||?->PspC*->SIG+TM(s)+FTSK(s)-HTH->	bacteria>firmicutes	1
<-Cluster85_4clades<-Cluster85_4clades<-?<-PspC*	bacteria>fcb group	1
<-Cluster857_2clades<-PspC*	bacteria>other unclassified bacteria	1
<-Cluster862_3clades||?-><-?<-Cluster87_3clades<-?||?->PspC*->	bacteria>deinococcus-thermus	1
<-Cluster887_2clades<-PspC*	bacteria>firmicutes	1
<-Cluster95_4clades<-?<-?<-PspC*	bacteria>fcb group	1
<-ComEA-HHH+S1<-?<-?<-PspC*<-?<-?<-?<-sf+TM(s)	bacteria>proteobacteria>gammaproteobacteria	1
<-ComEA-HHH+S1<-?||?-><-?<-PspC*	bacteria>proteobacteria>gammaproteobacteria	1
<-ComEA-HHH+S1<-?||?-><-?<-PspC*<-?<-?<-sf+TM(s)||TM->	bacteria>proteobacteria>gammaproteobacteria	1
<-CR-ATPase1<-PspC*<-PspB<-PspA	bacteria>proteobacteria>gammaproteobacteria	1
<-DAGKIN<-?<-?<-?<-SIGMA-HTH<-SIG+Toast-rack<-PspC*<-PspC*	bacteria>firmicutes	1
<-DAGKIN||?->?->?->Cluster551_3clades->?->?->PspC*->?->SMS-KaiC->	bacteria>actinobacteria	1
<-DUF1700-alpha-helical+PspC(s)+LiaI-LiaF-TM+Toast-rack*<-PADR-HTH||?-><-?||?-><-?<-Cluster977_2clades	bacteria>fcb group	1
<-DUF1700-alpha-helical+PspC+LiaI-LiaF-TM*<-PADR-HTH||SIG+TM(s)->REase->	bacteria>fcb group	1
<-HAM||?->?-><-?<-PSE||PspC*->	bacteria>nitrospirae	1
<-HEPN<-?<-REC+LuxR-HTH<-PspC+TM(s)+HISKIN*||PspC+TM(s)+Toast-rack*->?-><-?||?->?->SIG+TM(s)+ABC-ATPase-><-Cluster812_2clades	bacteria>actinobacteria	1
<-HEPN<-PspC*	bacteria>actinobacteria	1
<-HhH-RADC+JAB||?->HMA+TM(s)->?->?-><-QTG||?->PspC*->	bacteria>other unclassified bacteria	1
<-HMA+TM(s)<-?<-?||?->?-><-REC+LuxR-HTH<-PspC+TM(s)+HISKIN*||PspC+TM(s)+Toast-rack*->?-><-ABhydrolase	NA	1
<-HMA+TM(s)<-?||PspC*->LiaI-LiaF-TM+Toast-rack->LiaI-LiaF-TM+Toast-rack->	bacteria>other unclassified bacteria	1
<-HMA||PspC*->	archaea>euryarchaeota	1
<-HxxxH||Cluster534_2clades-><-REC+LuxR-HTH<-PspC+TM(s)+HISKIN*||PspC+TM(s)*->	bacteria>actinobacteria	1
<-LACI-HTH+PBPI<-SIG+TM(s)*<-RNA-Helicase<-O6MGT-HTH||?-><-?<-?||SIG+TM(s)+CBS->	bacteria>proteobacteria>gammaproteobacteria	1
<-LACI-HTH+PBPI||?->?->PspC*->SIG+TM(s)-><-?||?-><-?<-TM(s)	bacteria>firmicutes	1
<-LiaI-LiaF-TM+Toast-rack<-?<-PspC*	bacteria>fcb group	1
<-LiaI-LiaF-TM+Toast-rack<-PspC*||?->HMA+TM(s)->?->?->?-><-Cluster166_3clades	bacteria>other unclassified bacteria	1
<-LiaI-LiaF-TM+Toast-rack<-PspC+LiaI-LiaF-TM*<-?<-Cluster813_2clades<-?<-HAM	bacteria>other unclassified bacteria	1
<-LiaI-LiaF-TM+Toast-rack<-PspC+LiaI-LiaF-TM*<-METHYLASE	bacteria>fcb group	1
<-LiaI-LiaF-TM+Toast-rack<-PspC+LiaI-LiaF-TM*<-METHYLASE<-HDRnase	bacteria>fcb group	1
<-LiaI-LiaF-TM+Toast-rack<-PspC+LiaI-LiaF-TM*<-PspC*<-METHYLASE	bacteria>fcb group	1
<-LiaI-LiaF-TM+Toast-rack<-PspC+LiaI-LiaF-TM*<-TM	bacteria>fcb group	1
<-Mbetalac<-SIG+TM+Toast-rack<-PspC+LiaI-LiaF-TM*	bacteria>other unclassified bacteria	1
<-METHYLASE<-?<-?<-EMAP<-PSE<-?||PspC*->	bacteria>firmicutes	1
<-MODE-HTH+PBPII||SIG+TM(s)->?->?-><-SIG+TM(s)<-REC+LuxR-HTH<-PspC+TM(s)+HISKIN<-PspC+TM(s)+Toast-rack*<-Cluster187_2clades	bacteria>actinobacteria	1
<-MODE-HTH+PBPII||SIG+TM(s)->?-><-REC+LuxR-HTH<-PspC+TM(s)+HISKIN*||PspC+TM(s)+Toast-rack*->?-><-ABhydrolase	bacteria>actinobacteria	1
<-MODE-HTH+PBPII||SIG+TM(s)-><-?<-PspC+TM(s)+Toast-rack*||PspC+TM(s)+HISKIN*->REC+LuxR-HTH->?-><-ABhydrolase||HEPN->	bacteria>actinobacteria	1
<-MODE-HTH+PBPII||SIG+TM(s)-><-REC+LuxR-HTH<-PspC+TM(s)+HISKIN*||PspC+TM(s)+Toast-rack*->?-><-ABhydrolase	bacteria>actinobacteria	1
<-NtrC-AAA+FIS-HTH<-?<-ELM2<-TM(s)+IIGP1<-CR-ATPase1<-PspC*<-PspB<-PspA	bacteria>proteobacteria>gammaproteobacteria	1
<-NtrC-AAA+FIS-HTH<-?||PspA->PspB->PspC*->	bacteria>proteobacteria>gammaproteobacteria	1
<-NtrC-AAA+FIS-HTH<-TM(s)+IIGP1<-CR-ATPase1<-PspC*<-PspB<-PspA	bacteria>proteobacteria>gammaproteobacteria	1
<-NtrC-AAA+FIS-HTH<-TM(s)+IIGP1<-CR-ATPase1<-SIG+RHOD-CDC25<-Phageshock_PspD<-PspC*<-PspB<-PspA	bacteria>proteobacteria>gammaproteobacteria	1
<-NtrC-AAA+FIS-HTH||?-><-TM(s)+IIGP1<-CR-ATPase1<-Phageshock_PspD<-PspC*<-PspB<-PspA	bacteria>proteobacteria>gammaproteobacteria	1
<-NtrC-AAA+FIS-HTH||?->PspA->PspB->PspC*->	bacteria>proteobacteria>alphaproteobacteria	1
<-NtrC-AAA+FIS-HTH||?->PspA->PspB->PspC*->?->?->?->?->?->?->Cluster39_2clades->	bacteria>proteobacteria>alphaproteobacteria	1
<-NtrC-AAA+FIS-HTH||?->PspA->PspB->PspC*->PspC*->?->?->?->?->?->Cluster39_2clades->	bacteria>proteobacteria>alphaproteobacteria	1
<-NtrC-AAA+FIS-HTH||PspA->?->SIG+Toast-rack->SIG+Toast-rack*->SIG+TM(s)->ABC-ATPase->?->SIG+SMS-KaiC->	bacteria>proteobacteria>alphaproteobacteria	1
<-NtrC-AAA+FIS-HTH||PspA->PspB->PspC*->	bacteria>proteobacteria>deltaproteobacteria	1
<-NUDIX<-SIG+Toast-rack||?->?-><-?<-?<-PspC(s)*<-PSYN	bacteria>pvc group	1
<-Phageshock_PspD<-PspC*<-PspB<-PspA	NA	1
<-Phageshock_PspD<-PspC*<-PspB<-PspA||NtrC-AAA+FIS-HTH->Cluster134_2clades->SIG+TM(s)->SIG+TM(s)->ABC-ATPase->	bacteria>proteobacteria>gammaproteobacteria	1
<-PhoD||?->PspC*->Cluster364_3clades->	bacteria>firmicutes	1
<-PhoD||PspC*->	bacteria>actinobacteria	1
<-PspA<-PspC*<-PspC*<-PspA	bacteria>firmicutes	1
<-PspB+PspC*	bacteria>proteobacteria>gammaproteobacteria	1
<-PspC*	bacteria>proteobacteria>betaproteobacteria	1
<-PspC*	bacteria>pvc group	1
<-PspC*<-?<-?<-?<-HTH	bacteria>other unclassified bacteria	1
<-PspC*<-?<-?<-?<-SIG+HAMP+HISKIN<-REC+LuxR-HTH	bacteria>actinobacteria	1
<-PspC*<-?<-?<-SIG+TM(s)+ABC-ATPase<-SIG+TM(s)+ABC-ATPase	bacteria>spirochaetes	1
<-PspC*<-?<-?||SIGMA-HTH->	bacteria>actinobacteria	1
<-PspC*<-?<-Cluster304_2clades	bacteria>fusobacteria	1
<-PspC*<-?<-Cluster87_3clades	bacteria>firmicutes	1
<-PspC*<-?<-ComEA-HHH+S1||?->?->SIG+TM(s)->	bacteria>firmicutes	1
<-PspC*<-?<-ComEA-HHH+S1||?->SIG+TM(s)->?->?->Cluster73_4clades->	bacteria>firmicutes	1
<-PspC*<-?<-ComEA-HHH+S1||?->SIG+TM(s)->?-><-Cluster337_2clades	bacteria>firmicutes	1
<-PspC*<-?<-HEPN<-HEPN	bacteria>other unclassified bacteria	1
<-PspC*<-?<-PspA||NtrC-AAA+FIS-HTH->	bacteria>proteobacteria>gammaproteobacteria	1
<-PspC*<-?<-PspA||NtrC-AAA+FIS-HTH-><-PspC*<-PspA<-SIG+Toast-rack<-PspC*<-?<-PspA<-PspC*<-PspA	bacteria>spirochaetes	1
<-PspC*<-?<-PspB<-PspB<-?<-PspA	bacteria>pvc group	1
<-PspC*<-?<-PspC*	bacteria>fcb group	1
<-PspC*<-?<-RnaseT2	bacteria>other unclassified bacteria	1
<-PspC*<-?<-SIG+TM(s)+ABC-ATPase<-SIG+TM(s)+ABC-ATPase	bacteria>spirochaetes	1
<-PspC*<-?<-SIG+TM(s)<-Cluster229_2clades	bacteria>pvc group	1
<-PspC*<-?<-SIG+Toast-rack||PspC*->	bacteria>actinobacteria	1
<-PspC*<-?||?-><-?<-?<-sf+TM(s)	bacteria>proteobacteria>gammaproteobacteria	1
<-PspC*<-?||?-><-?<-PHP+ICAD+ComEA-HHH+N-OB<-?<-PSYN<-SIG+TM(s)	bacteria>actinobacteria	1
<-PspC*<-?||N-OB->?->?->Cluster446_3clades->	bacteria>other unclassified bacteria	1
<-PspC*<-ArgR-HTH	bacteria>fcb group	1
<-PspC*<-BLBD<-Cluster212_2clades	bacteria>proteobacteria>betaproteobacteria	1
<-PspC*<-Cluster1026_2clades<-?<-sGTP	bacteria>actinobacteria	1
<-PspC*<-Cluster110_2clades	bacteria>nitrospirae	1
<-PspC*<-Cluster1289_2clades	bacteria>fcb group	1
<-PspC*<-Cluster185_3clades||?-><-?||Cluster215_2clades->	bacteria>actinobacteria	1
<-PspC*<-Cluster579_2clades<-?<-ABC-ATPase	bacteria>other unclassified bacteria	1
<-PspC*<-Cluster752_3clades<-PSE<-ABC-ATPase<-?<-?<-Cluster327_2clades	bacteria>firmicutes	1
<-PspC*<-Cluster887_2clades<-?<-?<-Cluster283_3clades	bacteria>fcb group	1
<-PspC*<-DEAM<-Cluster1034_2clades	bacteria>proteobacteria>deltaproteobacteria	1
<-PspC*<-HhH-RADC	bacteria>firmicutes	1
<-PspC*<-PADR-HTH	bacteria>proteobacteria>gammaproteobacteria	1
<-PspC*<-PSE<-ABC-ATPase	bacteria>other unclassified bacteria	1
<-PspC*<-PspA	NA	1
<-PspC*<-PspB	bacteria>nitrospirae	1
<-PspC*<-PspB	bacteria>proteobacteria>deltaproteobacteria	1
<-PspC*<-PspB<-PspA<-?||NtrC-AAA+FIS-HTH->Cluster357_4clades->?->Cluster551_3clades->	bacteria>proteobacteria>alphaproteobacteria	1
<-PspC*<-PspB<-PspA||?->?-><-?<-TM<-ABhydrolase	bacteria>proteobacteria>alphaproteobacteria	1
<-PspC*<-PspB<-PspA||?->NtrC-AAA+FIS-HTH->	bacteria>proteobacteria>gammaproteobacteria	1
<-PspC*<-PspB<-PspA||?->NtrC-AAA+FIS-HTH->Cluster134_2clades->SIG+TM(s)->SIG+TM(s)->	bacteria>proteobacteria>gammaproteobacteria	1
<-PspC*<-PspB<-PspA||NtrC-AAA+FIS-HTH->	bacteria>proteobacteria>deltaproteobacteria	1
<-PspC*<-PspC*	bacteria>actinobacteria	1
<-PspC*<-PspC*<-?<-?<-?<-SIGMA-HTH	bacteria>caldiserica	1
<-PspC*<-SIG+TM(s)	bacteria>fcb group	1
<-PspC*<-SIG+TM(s)<-ABC-ATPase<-?<-Cluster372_2clades	bacteria>other unclassified bacteria	1
<-PspC*<-TM	bacteria>fcb group	1
<-PspC*<-TM(s)	bacteria>firmicutes	1
<-PspC*<-Toast-rack	bacteria>firmicutes	1
<-PspC*<-UbE1	archaea>euryarchaeota	1
<-PspC*||?->?->?->EMAP->?->?->METHYLASE->	bacteria>firmicutes	1
<-PspC*||?->?->EMAP->?->?->METHYLASE->	bacteria>firmicutes	1
<-PspC*||?->?->sf+TM(s)-><-?<-?<-PspC+TM(s)+Toast-rack*||PspC+TM(s)+HISKIN*->REC+LuxR-HTH->	bacteria>actinobacteria	1
<-PspC*||?->?->TM(s)->	bacteria>actinobacteria	1
<-PspC*||?-><-?<-?<-Cluster234_2clades<-Cluster236_2clades	bacteria>actinobacteria	1
<-PspC*||?-><-Cluster966_2clades<-?||?-><-Cluster1065_2clades	bacteria>other unclassified bacteria	1
<-PspC*||?-><-pPIWI	bacteria>fcb group	1
<-PspC*||?-><-SIGMA-HTH	bacteria>actinobacteria	1
<-PspC*||?->Cluster115_3clades->	bacteria>actinobacteria	1
<-PspC*||PADR-HTH->DUF1700-alpha-helical+TM(s)->SIG+Toast-rack->Cluster131_2clades->	bacteria>firmicutes	1
<-PspC*||PspC*->REC+LuxR-HTH->	bacteria>actinobacteria	1
<-PspC*||TM->	bacteria>actinobacteria	1
<-PspC*||TM-><-SIG+TM(s)	bacteria>actinobacteria	1
<-PspC*||tRNA-><-?<-?<-?<-?<-SMS-KaiC	bacteria>other unclassified bacteria	1
<-PspC*||tRNA->Cluster187_2clades->	bacteria>firmicutes	1
<-PspC+LiaI-LiaF-TM*	NA	1
<-PspC+LiaI-LiaF-TM*<-?<-?||A18->	bacteria>other unclassified bacteria	1
<-PspC+LiaI-LiaF-TM*<-Cluster193_3clades	bacteria>firmicutes	1
<-PspC+LiaI-LiaF-TM*<-CS||Cluster1042_2clades-><-?<-?<-ABC-ATPase	archaea>euryarchaeota	1
<-PspC+LiaI-LiaF-TM*<-SCPB-HTH<-Cluster446_3clades<-S2P+TM(s)<-Cluster186_3clades	bacteria>armatimonadetes	1
<-PspC+LiaI-LiaF-TM*<-SIG+TM(s)	bacteria>chloroflexi	1
<-PspC+LiaI-LiaF-TM*<-SIG+TM(s)+Toast-rack<-?<-LRP-HTH	archaea>euryarchaeota	1
<-PspC+LiaI-LiaF-TM*<-SIG+Toast-rack	bacteria>firmicutes	1
<-PspC+LiaI-LiaF-TM*||?->?-><-Cluster283_3clades<-TM(s)<-?<-Cluster964_2clades	bacteria>chloroflexi	1
<-PspC+TM(s)*||PspC+TM(s)+HISKIN*->REC+LuxR-HTH->RNA-Helicase->	bacteria>actinobacteria	1
<-PspC+TM(s)+HISKIN*	bacteria>actinobacteria	1
<-PspC+TM(s)+HISKIN*<-?<-PspC+TM(s)+Toast-rack*||?-><-?<-?<-?<-?<-ABhydrolase	bacteria>actinobacteria	1
<-PspC+TM(s)+HISKIN*||?-><-?||PspC+TM(s)+Toast-rack->	bacteria>actinobacteria	1
<-PspC+TM(s)+PspC*	bacteria>fcb group	1
<-PspC+TM(s)+PspC*<-Cluster857_2clades	bacteria>fcb group	1
<-PspC+TM(s)+Toast-rack*	bacteria>fcb group	1
<-PspC+TM(s)+Toast-rack*||PspC*->REC+LuxR-HTH->?-><-SIG+TM(s)+ABC-ATPase<-TM	bacteria>actinobacteria	1
<-PspC+TM(s)+Toast-rack*||PspC+TM(s)+HISKIN->REC+LuxR-HTH->?->?->?->?-><-SIG+TM(s)	bacteria>actinobacteria	1
<-PspC+TM(s)+Toast-rack*||PspC+TM(s)+HISKIN*-><-Cluster37_3clades<-?<-?||REC+LuxR-HTH->	bacteria>actinobacteria	1
<-PspC+TM(s)+Toast-rack*||PspC+TM(s)+HISKIN*->REC+LuxR-HTH->?->?-><-?||?-><-TM(s)<-ABC-ATPase	bacteria>actinobacteria	1
<-PspC+TM(s)+Toast-rack*||PspC+TM(s)+HISKIN*->REC+LuxR-HTH->?->?->SIG+TM(s)->RNA-Helicase->	bacteria>actinobacteria	1
<-PspC+TM(s)+Toast-rack*||PspC+TM(s)+HISKIN*->REC+LuxR-HTH->?-><-?<-sGTP<-?<-Cluster791_2clades	bacteria>actinobacteria	1
<-PspC+TM(s)+Toast-rack*||PspC+TM(s)+HISKIN*->REC+LuxR-HTH->?-><-?<-SIG+TM(s)||MODE-HTH+PBPII->	bacteria>actinobacteria	1
<-PspC+TM(s)+Toast-rack*||PspC+TM(s)+HISKIN*->REC+LuxR-HTH->?->SIG+TM(s)->RNA-Helicase->	bacteria>actinobacteria	1
<-PspC+TM(s)+Toast-rack*||PspC+TM(s)+HISKIN*->REC+LuxR-HTH-><-?<-?<-Cluster791_2clades	bacteria>actinobacteria	1
<-PspC+TM(s)+Toast-rack*||PspC+TM(s)+HISKIN*->REC+LuxR-HTH-><-?||?->Cluster73_4clades->	bacteria>actinobacteria	1
<-PspC+TM(s)+Toast-rack*||PspC+TM(s)+HISKIN*->REC+LuxR-HTH-><-?||DEOR-HTH+WYL(s)-C->	bacteria>actinobacteria	1
<-PspC+TM(s)+Toast-rack*||PspC+TM(s)+HISKIN*->REC+LuxR-HTH->SUA->SIG+TM(s)->	bacteria>actinobacteria	1
<-PspC+TM*	bacteria>firmicutes	1
<-PSYN||?-><-?<-?||?-><-?<-Cluster185_3clades<-PspC*<-BLBD<-Cluster212_2clades	bacteria>proteobacteria>betaproteobacteria	1
<-PurD-ATPgrasp<-?||PspC*->	bacteria>chloroflexi	1
<-RADICAL-SAM+TRAM||PspC*->	bacteria>spirochaetes	1
<-REC+LuxR-HTH<-PspC+TM(s)+HISKIN*<-?||PspC+TM(s)+Toast-rack*->?->PspC*->	bacteria>actinobacteria	1
<-REC+LuxR-HTH<-PspC+TM(s)+HISKIN*||?->PspC*->	bacteria>actinobacteria	1
<-REC+LuxR-HTH<-PspC+TM(s)+HISKIN*||PspC+TM(s)+Toast-rack*->?->?->?->?->Cluster81_2clades->	bacteria>actinobacteria	1
<-REC+LuxR-HTH<-PspC+TM(s)+HISKIN*||PspC+TM(s)+Toast-rack*->?->?-><-ABhydrolase	bacteria>actinobacteria	1
<-REC+LuxR-HTH<-PspC+TM(s)+HISKIN*||PspC+TM(s)+Toast-rack*->?-><-ABhydrolase||?->HEPN->	bacteria>actinobacteria	1
<-REC+LuxR-HTH<-PspC+TM(s)+HISKIN*||PspC+TM(s)+Toast-rack*->?-><-Cluster322_2clades<-?||?->?-><-ABhydrolase	bacteria>actinobacteria	1
<-REC+LuxR-HTH<-PspC+TM(s)+HISKIN*||PspC+TM(s)+Toast-rack*->?->LACI-HTH+PBPI-><-ABhydrolase	bacteria>actinobacteria	1
<-REC+LuxR-HTH<-PspC+TM(s)+HISKIN*||PspC+TM(s)+Toast-rack*->?->PspC*->	bacteria>actinobacteria	1
<-REC+LuxR-HTH<-PspC+TM(s)+HISKIN*||PspC+TM(s)+Toast-rack*->?->PspC*->PspC+TM(s)+Toast-rack*->?->SIG+CW-binding-EndolysinC->?-><-SIG+TM(s)	bacteria>actinobacteria	1
<-REC+LuxR-HTH<-PspC+TM(s)+HISKIN*||SIG+Toast-rack->	bacteria>actinobacteria	1
<-REC+LuxR-HTH<-PspC+TM(s)+HISKIN||?->PspC+TM(s)+Toast-rack*->?->?-><-?<-EMAP	bacteria>actinobacteria	1
<-REC+LuxR-HTH<-PspC+TM(s)+HISKIN||PspC+TM(s)+Toast-rack*->	bacteria>actinobacteria	1
<-REC+LuxR-HTH<-PspC+TM(s)+HISKIN||PspC+TM(s)+Toast-rack*->?-><-ABhydrolase	bacteria>actinobacteria	1
<-RNA-Helicase+A18<-PspC*	bacteria>fcb group	1
<-RNA-Helicase+A18<-TM<-Cluster37_3clades<-pPIWI<-?<-?<-SIG+TM(s)<-PspC*<-?<-Cluster95_4clades	bacteria>firmicutes	1
<-RNA-Helicase<-?<-?<-SIG+PspC+TM*	bacteria>other unclassified bacteria	1
<-RNA-Helicase||?-><-REC+LuxR-HTH<-PspC+TM(s)+HISKIN*||PspC+TM(s)+Toast-rack*->	bacteria>actinobacteria	1
<-RNA-Helicase||SIG+PhospholipaseD(s)->?-><-REC+LuxR-HTH<-PspC+TM(s)+HISKIN*||?->PspC*->	bacteria>actinobacteria	1
<-RNA-Helicase||SIG+PhospholipaseD(s)-><-?||?-><-REC+LuxR-HTH<-PspC+TM(s)+HISKIN*||PspC*->?->PspC*-><-ABhydrolase	bacteria>actinobacteria	1
<-RnaseIII<-?<-?||HxxxH->PspC*->?-><-?<-?<-?<-?<-?||HTH->	bacteria>other unclassified bacteria	1
<-RnaseT2<-Cluster186_3clades||?->?->?-><-PspC*<-?<-?||?-><-?<-?||SIG+SET->	bacteria>acidobacteria	1
<-SbcC(s)+ABC-ATPase+SbcC<-RNA-Helicase+A18<-Cluster215_2clades<-?<-?<-SIG+TM(s)<-PspC*<-SIG+HAMP+HISKIN<-REC+LuxR-HTH<-?||?->?->?-><-Cluster95_4clades	bacteria>firmicutes	1
<-SbcC(s)<-?||?->Cluster470_2clades-><-?<-?||?->PspC*->	bacteria>proteobacteria>alphaproteobacteria	1
<-SbcC(s)<-?||?->Cluster470_2clades-><-?<-?||?->PspC*-><-?<-Cluster221_3clades	bacteria>proteobacteria>alphaproteobacteria	1
<-SGS||?-><-?<-ABC-ATPase<-?<-?<-PspC+TM(s)+Toast-rack*<-PADR-HTH	bacteria>other unclassified bacteria	1
<-sGTP<-PspC*||QTG->HhH-RADC+JAB->	bacteria>other unclassified bacteria	1
<-SIG+CW-binding-EndolysinC<-PspC*<-?<-PspC+TM(s)+Toast-rack*||PspC+TM(s)+HISKIN*->REC+LuxR-HTH-><-Cluster115_3clades	bacteria>actinobacteria	1
<-SIG+HAMP+HISKIN<-REC+LuxR-HTH<-?<-?<-?<-?<-PspC*<-PADR-HTH	bacteria>other unclassified bacteria	1
<-SIG+HAMP+HISKIN<-REC+LuxR-HTH||?-><-PspC*<-PSE<-?<-REC+LuxR-HTH||?-><-?<-?<-Cluster87_3clades	bacteria>other unclassified bacteria	1
<-SIG+PAP2||PADR-HTH->DUF1700-alpha-helical+PspC+LiaI-LiaF-TM+Toast-rack*->	bacteria>fcb group	1
<-SIG+PspC*	bacteria>firmicutes	1
<-SIG+PspC*	bacteria>other unclassified bacteria	1
<-SIG+PUA<-TM<-CHTH+DSBH<-?<-ncRNA<-Cluster283_3clades<-?<-PspC*<-?<-?<-ArgR-HTH	bacteria>fcb group	1
<-SIG+RHOD-CDC25<-Cluster290_3clades<-Cluster115_3clades<-PspC*	bacteria>other unclassified bacteria	1
<-SIG+RHOD-CDC25<-Phageshock_PspD<-PspC*<-PspB<-PspA	NA	1
<-SIG+SMS-KaiC<-?<-ABC-ATPase<-SIG+TM(s)<-SIG+Toast-rack*<-SIG+Toast-rack<-?<-PspA||NtrC-AAA+FIS-HTH->	bacteria>proteobacteria>alphaproteobacteria	1
<-SIG+SMS-KaiC||?->?-><-PspC*<-?<-Cluster551_3clades	bacteria>proteobacteria>betaproteobacteria	1
<-SIG+TM(s)*	bacteria>firmicutes	1
<-SIG+TM(s)<-?<-?<-SIG+TM+PspC*	bacteria>cyanobacteria	1
<-SIG+TM(s)<-?<-Cluster784_2clades<-PurD-ATPgrasp<-RNA-Helicase<-?<-REC+LuxR-HTH<-PspC+TM(s)+HISKIN*||PspC+TM(s)+Toast-rack*->?-><-PEP-utilisers-N+PEP-utilisers(s)-C	bacteria>actinobacteria	1
<-SIG+TM(s)<-?<-PspC*<-PspB<-DUF1700-alpha-helical+PspC+LiaI-LiaF-TM+Toast-rack*<-PspA	bacteria>proteobacteria>gammaproteobacteria	1
<-SIG+TM(s)<-?||?-><-?||LRP-HTH->?->SIG+TM(s)+Toast-rack->PspC+LiaI-LiaF-TM*->?->?-><-?<-PSE<-?||RADICAL-SAM->	archaea>euryarchaeota	1
<-SIG+TM(s)<-?||CHTH+DSBH-><-PspC*	bacteria>firmicutes	1
<-SIG+TM(s)<-?||PADR-HTH->DUF1700-alpha-helical+PspC+LiaI-LiaF-TM*->	bacteria>other unclassified bacteria	1
<-SIG+TM(s)<-ABC-ATPase<-?<-?<-RNA-Helicase+A18<-PspC*	bacteria>fcb group	1
<-SIG+TM(s)<-ABC-ATPase<-?<-PspC+LiaI-LiaF-TM*	archaea>euryarchaeota	1
<-SIG+TM(s)<-ABC-ATPase<-SIG+TM(s)||ABhydrolase-><-?<-PspC+TM(s)+Toast-rack*||PspC+TM(s)+HISKIN*->REC+LuxR-HTH->	bacteria>actinobacteria	1
<-SIG+TM(s)<-PSE<-?||?-><-REC+LuxR-HTH<-PspC+TM(s)+HISKIN*||PspC+TM(s)+Toast-rack*-><-ABhydrolase	bacteria>actinobacteria	1
<-SIG+TM(s)<-PspC*	bacteria>other unclassified bacteria	1
<-SIG+TM(s)<-PspC*<-Cluster594_2clades<-?<-SbcC(s)+ABC-ATPase+SbcC<-RNA-Helicase+A18	bacteria>firmicutes	1
<-SIG+TM(s)<-PspC*<-Cluster95_4clades	bacteria>firmicutes	1
<-SIG+TM(s)<-PspC*<-PspC*<-Toast-rack<-?<-?<-SbcC(s)+ABC-ATPase+SbcC	bacteria>firmicutes	1
<-SIG+TM(s)<-PspC*<-SIG+Toast-rack<-DUF1700-alpha-helical+TM(s)<-PADR-HTH	bacteria>firmicutes	1
<-SIG+TM(s)<-PspC*<-Toast-rack<-?<-SbcC(s)+ABC-ATPase+SbcC<-RNA-Helicase+A18<-?<-?<-?||PspC*->	bacteria>firmicutes	1
<-SIG+TM(s)<-PspC*||?->SIG+RnaseH-><-?<-ABC-ATPase	bacteria>proteobacteria>deltaproteobacteria	1
<-SIG+TM(s)<-REC+LuxR-HTH<-PspC+TM(s)+HISKIN*||PspC+TM(s)+Toast-rack*->?-><-ABhydrolase	bacteria>actinobacteria	1
<-SIG+TM(s)<-SIG+TM(s)<-?||?->?-><-REC+LuxR-HTH<-PspC+TM(s)+HISKIN*||?->?->PspC*-><-PSE||Cluster773_2clades->	bacteria>actinobacteria	1
<-SIG+TM(s)<-SIG+TM(s)<-?||TM(s)->?->?->PspC*-><-?<-SIG+PAP2<-SIG+PAP2	bacteria>actinobacteria	1
<-SIG+TM(s)<-SUA<-REC+LuxR-HTH<-PspC+TM(s)+HISKIN*||PspC+TM(s)+Toast-rack*->	bacteria>actinobacteria	1
<-SIG+TM(s)||?->?->?->?-><-?||?->PspC*->	bacteria>actinobacteria	1
<-SIG+TM(s)||?-><-PspC*	bacteria>firmicutes	1
<-SIG+TM(s)||MODE-HTH+PBPII->ABhydrolase->?->?-><-PspC+TM(s)+Toast-rack*||PspC+TM(s)+HISKIN*->REC+LuxR-HTH->	bacteria>actinobacteria	1
<-SIG+TM(s)||MODE-HTH+PBPII->SIG+PAP2->ABhydrolase-><-?<-PspC+TM(s)+Toast-rack*||PspC+TM(s)+HISKIN*->REC+LuxR-HTH->	bacteria>actinobacteria	1
<-SIG+TM(s)||PspC*->PspC+LiaI-LiaF-TM*->LiaI-LiaF-TM+Toast-rack-><-LACI-HTH+PBPI	bacteria>dictyoglomi	1
<-SIG+TM*	bacteria>proteobacteria>gammaproteobacteria	1
<-SIG+Toast-rack<-?<-DUF1700-alpha-helical+PspC+LiaI-LiaF-TM+Toast-rack*<-PADR-HTH	bacteria>fcb group	1
<-SIG+Toast-rack<-?<-PspC*<-DUF1700-alpha-helical+TM(s)<-PADR-HTH	bacteria>spirochaetes	1
<-SIG+Toast-rack<-DUF1700-alpha-helical+PspC+LiaI-LiaF-TM+Toast-rack*<-PADR-HTH||?->?-><-MODE-HTH+PBPII	bacteria>fcb group	1
<-SIG+Toast-rack<-PspC*	bacteria>chloroflexi	1
<-SIG+Toast-rack<-PspC*<-?<-PspA||NtrC-AAA+FIS-HTH-><-PspC*<-PspA	bacteria>spirochaetes	1
<-SIG+Toast-rack<-PspC+LiaI-LiaF-TM*	bacteria>other unclassified bacteria	1
<-SIG+Toast-rack<-PspC+TM(s)+Toast-rack*<-SIG+Toast-rack<-?<-PspA||NtrC-AAA+FIS-HTH->	bacteria>proteobacteria>alphaproteobacteria	1
<-SIG+Toast-rack<-SIG+Toast-rack<-?<-DUF1700-alpha-helical+PspC+LiaI-LiaF-TM+Toast-rack*<-PADR-HTH	bacteria>fcb group	1
<-SIG+Tox-TGase<-?<-SIG+TM<-?<-PspC*	bacteria>other unclassified bacteria	1
<-SIGMA-HTH<-PspC*	bacteria>fcb group	1
<-SIGMA-HTH<-SIG+ZNR+PspC*	bacteria>other unclassified bacteria	1
<-SIGMA-HTH||REC+LuxR-HTH->SIG+HAMP+HISKIN->?->?->PspC*->	bacteria>actinobacteria	1
<-SMS-KaiC<-PSE<-?<-?<-?<-?<-PspC*	bacteria>other unclassified bacteria	1
<-SMS-KaiC<-PspC*<-Cluster115_3clades	bacteria>firmicutes	1
<-STAT<-PspC*	archaea>asgard group	1
<-STAT<-TM(s)+IIGP1<-CR-ATPase1<-PspC*<-PspB<-PspA	NA	1
<-SUA<-PspC+LiaI-LiaF-TM*<-?<-?||HhH-GPD-><-PSYN<-Cluster335_2clades	bacteria>other unclassified bacteria	1
<-TM(s)+IIGP1<-CR-ATPase1<-?<-PspC*<-PspB<-PspA	bacteria>proteobacteria>gammaproteobacteria	1
<-TM(s)+IIGP1<-PSE<-Phageshock_PspD<-PspC*<-PspB<-PspA	bacteria>proteobacteria>gammaproteobacteria	1
<-TM(s)+PspC*<-ISOCOT||?->MuB-ATPase->?->?->SPOUT->	bacteria>fcb group	1
<-TM(s)<-?<-?||?-><-PspC*	bacteria>fcb group	1
<-TM(s)<-?<-?||PspC*-><-?<-SIG+TM(s)<-SIG+TM(s)	bacteria>actinobacteria	1
<-TM(s)||Cluster229_2clades->?->?->NUDIX->TM-><-PspC*	bacteria>proteobacteria>alphaproteobacteria	1
<-TM(s)||PADR-HTH->PspC*->	bacteria>other unclassified bacteria	1
<-TM<-?<-?<-SIG+TM(s)<-PspC*<-?<-ABC-ATPase<-ABC-ATPase<-?<-?<-?<-SIG+HAMP+HISKIN	bacteria>firmicutes	1
<-TM<-?<-Cluster1273_2clades<-?<-?<-?<-PspC*<-Cluster304_2clades	bacteria>fusobacteria	1
<-TM<-Cluster37_3clades<-pPIWI<-?<-?<-SIG+TM(s)<-PspC*	bacteria>firmicutes	1
<-TM<-Cluster37_3clades<-pPIWI<-?<-?<-SIG+TM(s)<-PspC*<-Cluster95_4clades	bacteria>firmicutes	1
<-TM<-Cluster87_3clades<-?<-?<-?<-SIG+TM(s)<-PspC*<-?<-SbcC(s)+ABC-ATPase+SbcC<-RNA-Helicase+A18	bacteria>firmicutes	1
<-TM<-REC+LuxR-HTH<-PspC+TM(s)+HISKIN*||PspC*->	bacteria>actinobacteria	1
<-TM||sf+TM(s)->?->?->?->PspC*->	bacteria>proteobacteria>gammaproteobacteria	1
<-TM||sf+TM(s)->?->?->?->PspC*->?->?-><-?<-tRNA<-?<-Cluster1021_2clades	bacteria>proteobacteria>gammaproteobacteria	1
<-UDG<-?||?-><-PspC*<-SIG+Toast-rack<-PADR-HTH	bacteria>firmicutes	1
<-ZNR<-?||?->?->?-><-PspC*	bacteria>fcb group	1
35exo->PspC+LiaI-LiaF-TM*->LiaI-LiaF-TM+Toast-rack->	bacteria>other unclassified bacteria	1
A18->?->Cluster95_4clades->PspC*->SIG+TM(s)->?->?->pPIWI->Cluster37_3clades-><-?<-Ferredoxin-RRM	bacteria>firmicutes	1
ABC-ATPase->?->?->?->?-><-?||?->PspC+TM(s)+Toast-rack*->PspC+TM(s)+HISKIN*->REC+LuxR-HTH-><-TM(s)<-?<-?<-?<-?||REC+LuxR-HTH->	bacteria>actinobacteria	1
ABC-ATPase->?->?->Cluster287_4clades->Cluster39_2clades->Cluster144_2clades->PspC*->	bacteria>fcb group	1
ABC-ATPase->?-><-?<-Cluster773_2clades||ABhydrolase-><-PspC*<-?<-?||PspC+TM(s)+HISKIN*->REC+LuxR-HTH-><-?||?-><-SIG+PhospholipaseD(s)||RNA-Helicase->	bacteria>actinobacteria	1
ABC-ATPase->?->Cluster579_2clades->PspC*->	bacteria>other unclassified bacteria	1
ABC-ATPase->?->ComEA-HHH+S1->?->PspC*->	bacteria>firmicutes	1
ABC-ATPase-><-PspC*<-?<-ComEA-HHH+S1	bacteria>firmicutes	1
ABC-ATPase->ABC-ATPase->?->PSE->PspC*->SIG+TM(s)->?->?->pPIWI->Cluster37_3clades->	bacteria>firmicutes	1
ABC-ATPase->ABC-ATPase->?->PspC*->SIG+TM(s)->?->?->TM->	bacteria>firmicutes	1
ABC-ATPase->CHC2+Toprim-DNAG->SIGMA-HTH->Cluster144_2clades->?->?->PspC*->?->?->?-><-ArgR-HTH	bacteria>firmicutes	1
ABC-ATPase->PADR-HTH->PspC+LiaI-LiaF-TM+Toast-rack*->SIG+TM(s)->SGS->?->A18->	bacteria>other unclassified bacteria	1
ABC-ATPase->PspC*->	bacteria>other unclassified bacteria	1
ABC-ATPase->PspC*-><-Cluster85_4clades	bacteria>other unclassified bacteria	1
ABhydrolase->?->?->?->?-><-?<-PspC+TM(s)+Toast-rack*||PspC+TM(s)+HISKIN*->REC+LuxR-HTH->	bacteria>actinobacteria	1
ABhydrolase->?-><-?<-?<-?<-?<-PspC+TM(s)+Toast-rack*||PspC+TM(s)+HISKIN*->REC+LuxR-HTH->	bacteria>actinobacteria	1
ABhydrolase->?-><-?<-PspC+TM(s)+Toast-rack*||PspC+TM(s)+HISKIN*->REC+LuxR-HTH-><-Cluster1111_2clades	bacteria>actinobacteria	1
ABhydrolase->?-><-PspC*<-?<-PspC+TM(s)+Toast-rack*||?->PspC+TM(s)+HISKIN*->REC+LuxR-HTH->	bacteria>actinobacteria	1
ABhydrolase-><-?<-?<-PspC+TM(s)+Toast-rack*	bacteria>actinobacteria	1
ABhydrolase-><-?<-?<-PspC+TM(s)+Toast-rack*||PspC+TM(s)+HISKIN*->	bacteria>actinobacteria	1
ABhydrolase-><-?<-PSE||PspC+TM(s)+HISKIN*->REC+LuxR-HTH->?-><-?||?->?-><-?<-SIG+TM(s)	bacteria>actinobacteria	1
ABhydrolase-><-?<-PspC+TM(s)+Toast-rack*||?->?->PspC+TM(s)+HISKIN*->	bacteria>actinobacteria	1
ABhydrolase-><-?<-PspC+TM(s)+Toast-rack*||PspC+TM(s)+HISKIN->REC+LuxR-HTH-><-?||?-><-?||RADICAL-SAM->SIG+TM(s)->	bacteria>actinobacteria	1
ABhydrolase-><-?<-PspC+TM(s)+Toast-rack*||PspC+TM(s)+HISKIN*->?->?->?->?->REC+LuxR-HTH->	bacteria>actinobacteria	1
ABhydrolase-><-PspC*<-?<-?<-PspC+TM(s)+Toast-rack*||PspC+TM(s)+HISKIN*->REC+LuxR-HTH->	bacteria>actinobacteria	1
ABhydrolase-><-PspC*<-?<-PspC+TM(s)+Toast-rack*||PspC+TM(s)+HISKIN*->REC+LuxR-HTH->	bacteria>actinobacteria	1
ABhydrolase-><-PspC*||?->?->?-><-?<-?<-PspC+TM(s)+Toast-rack*	bacteria>actinobacteria	1
ABhydrolase-><-PspC+TM(s)+Toast-rack*	bacteria>actinobacteria	1
ABhydrolase-><-PspC+TM(s)+Toast-rack*||PspC+TM(s)+HISKIN*->REC+LuxR-HTH-><-?||?->?->?-><-?<-TM(s)	bacteria>actinobacteria	1
ABhydrolase->SIG+TM(s)-><-?<-PspC+LiaI-LiaF-TM+Toast-rack*||PspC+TM(s)+HISKIN*->REC+LuxR-HTH->	bacteria>actinobacteria	1
ACT->?-><-PspC*	bacteria>fcb group	1
ACT->?-><-TM||?-><-REC+LuxR-HTH<-PspC+TM(s)+HISKIN*<-?<-PspC+TM(s)+Toast-rack*||?-><-?<-?<-?<-?<-ABhydrolase	bacteria>actinobacteria	1
ArgR-HTH->?->?->PspC*->	bacteria>fcb group	1
ArgR-HTH-><-?<-?<-?<-PspC*<-?<-?<-Cluster144_2clades<-SIGMA-HTH<-CHC2+Toprim-DNAG<-ABC-ATPase	bacteria>firmicutes	1
ArgR-HTH->PspC*->	bacteria>fcb group	1
ArgR-HTH->PspC*->CHTH+DSBH->TM->	bacteria>fcb group	1
CBS->?->?->?->?->?->?->PspC+LiaI-LiaF-TM*-><-SIG+TM(s)<-ABC-ATPase	archaea>euryarchaeota	1
CHC2+Toprim-DNAG->SIGMA-HTH->Cluster144_2clades->?->?->PspC*->	bacteria>firmicutes	1
Cluster1049_2clades-><-?<-?<-?<-?<-Cluster185_3clades<-PspC*<-BLBD<-Cluster212_2clades	bacteria>proteobacteria>betaproteobacteria	1
Cluster1058_2clades-><-SIG+TM(s)<-ABC-ATPase<-SIG+TM(s)||ABhydrolase-><-?<-PspC+TM(s)+Toast-rack*	bacteria>actinobacteria	1
Cluster1063_2clades-><-PspC*	bacteria>deinococcus-thermus	1
Cluster110_2clades->PspC*->?->Cluster110_2clades-><-?||sGTP->?-><-?||Cluster1265_2clades->	bacteria>actinobacteria	1
Cluster1136_2clades->PspC*->	bacteria>firmicutes	1
Cluster1136_2clades->TM-><-?<-PspC*<-?<-?<-?<-?<-?<-?<-Cluster552_2clades	bacteria>actinobacteria	1
Cluster115_3clades-><-?<-?<-PspC+LiaI-LiaF-TM*	bacteria>firmicutes	1
Cluster115_3clades-><-REC+LuxR-HTH<-PspC+TM(s)+HISKIN*||PspC*->SIG+CW-binding-EndolysinC->	bacteria>actinobacteria	1
Cluster115_3clades-><-REC+LuxR-HTH<-PspC+TM(s)+HISKIN*||PspC+TM(s)+Toast-rack*->?->PspC*->SIG+CW-binding-EndolysinC->	bacteria>actinobacteria	1
Cluster115_3clades-><-REC+LuxR-HTH<-PspC+TM(s)+HISKIN*||PspC+TM(s)+Toast-rack*->?->SIG+CW-binding-EndolysinC->?-><-SIG+TM(s)	bacteria>actinobacteria	1
Cluster115_3clades-><-REC+LuxR-HTH<-PspC+TM(s)+HISKIN*||SIG+PspC+TM(s)+Toast-rack*->?->PspC*->	bacteria>actinobacteria	1
Cluster115_3clades-><-REC+LuxR-HTH<-PspC+TM(s)+HISKIN*||SIG+PspC+TM(s)+Toast-rack*->?->PspC*->	NA	1
Cluster1172_2clades->?->?->?->?->SIG+RnaseH-><-SIG+TM(s)*	bacteria>actinobacteria	1
Cluster166_3clades-><-?<-?<-?<-HMA+TM(s)<-?||PspC*->?->LiaI-LiaF-TM+Toast-rack->	bacteria>other unclassified bacteria	1
Cluster166_3clades->tRNA-><-?<-?<-?<-HMA+TM(s)<-?||PspC*->LiaI-LiaF-TM+Toast-rack->LiaI-LiaF-TM+Toast-rack-><-?<-UDG||?-><-Cluster700_2clades	bacteria>other unclassified bacteria	1
Cluster193_3clades->PspC+LiaI-LiaF-TM*->	bacteria>firmicutes	1
Cluster221_3clades->?-><-PspC*	bacteria>proteobacteria>alphaproteobacteria	1
Cluster229_2clades->?->?->?->NUDIX->TM-><-PspC*	bacteria>proteobacteria>alphaproteobacteria	1
Cluster236_2clades->Cluster234_2clades->?-><-SUA<-PspC+LiaI-LiaF-TM*<-?||HhH-GPD-><-PSYN	bacteria>other unclassified bacteria	1
Cluster236_2clades->Cluster234_2clades-><-?||PspC+LiaI-LiaF-TM*->LiaI-LiaF-TM+Toast-rack->Toast-rack->	bacteria>other unclassified bacteria	1
Cluster278_2clades-><-?<-Cluster39_2clades<-?<-?<-?<-PspC*<-PspB<-PspA	bacteria>proteobacteria>alphaproteobacteria	1
Cluster278_2clades-><-?<-Cluster39_2clades<-?<-?<-PspC*<-PspB<-PspA	bacteria>proteobacteria>alphaproteobacteria	1
Cluster278_2clades-><-?<-Cluster39_2clades<-?<-PspC*<-PspB<-PspA||NtrC-AAA+FIS-HTH->	bacteria>proteobacteria>alphaproteobacteria	1
Cluster278_2clades-><-PspC*	bacteria>proteobacteria>gammaproteobacteria	1
Cluster283_3clades->?-><-?||?-><-PurD-ATPgrasp<-?||PspC*->	bacteria>chloroflexi	1
Cluster283_3clades->GNTR-HTH+UTRA-><-REC+LuxR-HTH<-PspC+TM(s)+HISKIN*||PspC+TM(s)*->	bacteria>actinobacteria	1
Cluster287_4clades->Cluster552_2clades->?->?->?->?->PspC*-><-TM	bacteria>actinobacteria	1
Cluster290_3clades-><-?||PspC*->Cluster534_2clades->	bacteria>actinobacteria	1
Cluster335_2clades->PSYN-><-HhH-GPD||?->PspC+LiaI-LiaF-TM*->SUA-><-?<-Cluster234_2clades<-Cluster236_2clades	bacteria>other unclassified bacteria	1
Cluster337_2clades->?->SIG+TM(s)->PspC*->	bacteria>proteobacteria>gammaproteobacteria	1
Cluster372_2clades->?->?-><-?<-?<-?<-?<-PspC*<-?<-Cluster87_3clades||Cluster1086_2clades->	bacteria>other unclassified bacteria	1
Cluster374_3clades->PSYN-><-?||TET-JBP->RnasePH(s)+KH+S1->?->?->PspC*->ISOCOT->?->PELOTA-><-?||?->?-><-REC+LuxR-HTH	bacteria>proteobacteria>gammaproteobacteria	1
Cluster534_2clades->SIG+TM(s)-><-?<-PspC(s)+LiaI-LiaF-TM+Toast-rack(s)*<-PADR-HTH	bacteria>fcb group	1
Cluster534_2clades->SIG+TM(s)-><-PspC(s)+LiaI-LiaF-TM+Toast-rack(s)*<-PADR-HTH	bacteria>fcb group	1
Cluster539_2clades->?-><-?<-?<-PspC*||PspC+TM(s)+HISKIN*->REC+LuxR-HTH->tRNA->?->KOW->	bacteria>actinobacteria	1
Cluster539_2clades-><-?<-PspC*||PspC+TM(s)+HISKIN*->REC+LuxR-HTH-><-PSE<-TM	bacteria>actinobacteria	1
Cluster551_3clades->?->?->PspC*->?->SMS-KaiC->	bacteria>actinobacteria	1
Cluster559_2clades-><-?||PspC*->	archaea>euryarchaeota	1
Cluster579_2clades-><-DUF1700-alpha-helical+PspC+LiaI-LiaF-TM+Toast-rack*<-PADR-HTH	bacteria>fcb group	1
Cluster594_2clades->?-><-REC+LuxR-HTH<-PspC+TM(s)+HISKIN*||PspC*->PspC+TM(s)+Toast-rack*->	bacteria>actinobacteria	1
Cluster633_3clades->?->?-><-?<-PspC*	archaea>euryarchaeota	1
Cluster700_2clades-><-?||UDG->?-><-LiaI-LiaF-TM+Toast-rack<-LiaI-LiaF-TM+Toast-rack<-PspC*||?->HMA+TM(s)->?->?->?-><-tRNA<-Cluster166_3clades	bacteria>other unclassified bacteria	1
Cluster722_2clades->LDcluster4->?-><-PspC*	bacteria>proteobacteria>alphaproteobacteria	1
Cluster752_3clades->?->?->?->PspC+LiaI-LiaF-TM*->?->LiaI-LiaF-TM+Toast-rack->?-><-SIG+Toast-rack	bacteria>fcb group	1
Cluster812_2clades-><-?<-?<-PspC+TM(s)+Toast-rack*||PspC+TM(s)+HISKIN*->REC+LuxR-HTH->	bacteria>actinobacteria	1
Cluster813_2clades->ABhydrolase->?-><-?<-PspC+TM(s)+Toast-rack*||PspC+TM(s)+HISKIN*->REC+LuxR-HTH-><-?<-?||TM(s)->	bacteria>actinobacteria	1
Cluster818_2clades-><-?<-?||?-><-?<-?||PspC*->	bacteria>firmicutes	1
Cluster83_1clades*-><-Cluster335_2clades	bacteria>proteobacteria>gammaproteobacteria	1
Cluster83_1clades*-><-Cluster335_2clades<-?<-SIG+PUA	bacteria>proteobacteria>gammaproteobacteria	1
Cluster85_4clades-><-PspC*	bacteria>other unclassified bacteria	1
Cluster95_4clades->?-><-?<-?||?->PspC*->?->SIG+TM(s)->?->Cluster81_2clades->	bacteria>fcb group	1
Cluster95_4clades->?->Cluster862_3clades->O6MGT-HTH-><-LiaI-LiaF-TM+Toast-rack<-PspC+LiaI-LiaF-TM*||?->?->?->?->DHH->Cluster702_3clades->	bacteria>fcb group	1
Cluster95_4clades->PspC*->SIG+TM(s)->?->?->pPIWI->Cluster37_3clades->	bacteria>firmicutes	1
Cluster966_2clades->PspC*->	bacteria>actinobacteria	1
Cluster977_2clades-><-?<-SIG+TM(s)<-?||?->ComEA-HHH+S1->?->PspC*->	bacteria>firmicutes	1
Cluster982_2clades-><-PspC*<-?||?->?->ABC-ATPase->?->Cluster812_2clades->	bacteria>firmicutes	1
ComEA-HHH+S1-><-?||PspC*->	bacteria>actinobacteria	1
ComEA-HHH+S1-><-PspC*	bacteria>fcb group	1
ComEA-HHH+S1->SIG+TM(s)->?->PspC*->	bacteria>fcb group	1
DAGKIN->?-><-PspC(s)+LiaI-LiaF-TM+Toast-rack(s)*<-PADR-HTH	bacteria>fcb group	1
DAGKIN-><-LiaI-LiaF-TM+Toast-rack<-PspC+LiaI-LiaF-TM*	bacteria>thermotogae	1
DDRP-ZNR+AT-HOOK-like+DDRP-betaprime+BBM2-DDRP+SBHM-DDRP(s)->?-><-?||PADR-HTH->DUF1700-alpha-helical+PspC+TM(s)+Toast-rack*->?-><-Cluster357_4clades	bacteria>fcb group	1
DDRP-ZNR+AT-HOOK-like+DDRP-betaprime+BBM2-DDRP+SBHM-DDRP(s)->?-><-PspC*	bacteria>proteobacteria>alphaproteobacteria	1
DEAM->?->?->?->?-><-PspC*	bacteria>fusobacteria	1
DEAM-><-SGS<-?<-?<-DUF1700-alpha-helical+PspC+LiaI-LiaF-TM+Toast-rack*<-PADR-HTH<-?<-ABC-ATPase	NA	1
DUF1700-alpha-helical+TM(s)->SIG+Toast-rack->PspC*->	bacteria>firmicutes	1
ENOYCOADEHYD-><-?<-PspC*<-PspA	bacteria>proteobacteria>gammaproteobacteria	1
ENOYCOADEHYD-><-Cluster982_2clades<-PspC*<-PspB<-PspA	bacteria>proteobacteria>deltaproteobacteria	1
Ferredoxin-RRM->PSE->?->tRNA-><-PspC*<-?<-?<-?<-?<-?||SIG+TM(s)->	bacteria>actinobacteria	1
GNTR-HTH->?-><-PspC*	bacteria>actinobacteria	1
GNTR-HTH->ABC-ATPase->?->Cluster887_2clades-><-PspC*	bacteria>firmicutes	1
GNTR-HTH+UTRA->?-><-SIG+TM(s)<-PspC*	bacteria>firmicutes	1
GNTR-HTH+UTRA-><-SIG+LTD+IG+Calcineurin<-?<-?<-SIG+TM(s)<-PspC*<-Toast-rack	bacteria>firmicutes	1
HAM->?->Cluster813_2clades->?->PspC+LiaI-LiaF-TM*->LiaI-LiaF-TM+Toast-rack->	bacteria>other unclassified bacteria	1
HEPN->ABC-ATPase->?->?->?->?->UbE1->PspC*->	bacteria>other unclassified bacteria	1
HEPN->HEPN->PspC*->?->?->?->?->Cluster320_2clades->	bacteria>other unclassified bacteria	1
HhH-GPD->?-><-PspA<-PspC*	bacteria>firmicutes	1
HhH-RADC+JAB->PspC*->Cluster290_3clades->	bacteria>firmicutes	1
HMA->?-><-Cluster372_2clades||?->Cluster470_2clades->?-><-?||PspC*->	bacteria>other unclassified bacteria	1
HTH->?->?->?->MACRODOMAIN-><-PspC*<-HxxxH||?-><-PHP+ICAD+ComEA-HHH+N-OB	bacteria>other unclassified bacteria	1
HTH->?-><-?||?->?-><-PspC*<-HxxxH	bacteria>other unclassified bacteria	1
HTH->?-><-PspC*	archaea>dpann group	1
HxxxH->?->?-><-PspC*<-TM(s)	bacteria>firmicutes	1
ISOCOT->PspC*->?-><-TM<-SIGMA-HTH	bacteria>other unclassified bacteria	1
ISOCOT->TM(s)+PspC*-><-7TMR-HDED	bacteria>fcb group	1
ISOCOT->TM(s)+PspC*-><-7TMR-HDED<-7TMR-HDED<-35exo	bacteria>fcb group	1
LRP-HTH->?->PspC+LiaI-LiaF-TM*->SIG+TM(s)+Toast-rack->	archaea>euryarchaeota	1
LRP-HTH->?->SIG+TM(s)+Toast-rack->PspC+LiaI-LiaF-TM*->	archaea>euryarchaeota	1
LRP-HTH->?->SIG+TM(s)+Toast-rack->PspC+LiaI-LiaF-TM*->?->?-><-?<-?<-?||RADICAL-SAM->	archaea>euryarchaeota	1
MACRODOMAIN-><-REC+LuxR-HTH<-PspC+TM(s)+HISKIN*	bacteria>actinobacteria	1
MACRODOMAIN-><-REC+LuxR-HTH<-PspC+TM(s)+HISKIN*||PspC+TM(s)*->	bacteria>actinobacteria	1
METHYLASE-><-?<-PspC+TM(s)+Toast-rack*<-?||PspC+TM(s)+HISKIN*->REC+LuxR-HTH-><-?<-?||RNA-Helicase->	bacteria>actinobacteria	1
METHYLASE->PspC*->PSE->LiaI-LiaF-TM+Toast-rack->	bacteria>fcb group	1
METHYLASE->PspC*->PspC+LiaI-LiaF-TM*->LiaI-LiaF-TM+Toast-rack->	bacteria>fcb group	1
METHYLASE->PspC+TM(s)+PspC*->	bacteria>fcb group	1
MODE-HTH+PBPII->?->PspC*->	bacteria>actinobacteria	1
MODE-HTH+PBPII-><-?||?-><-?||?->?-><-PspC*<-?<-?<-SIG+HAMP+HISKIN<-REC+LuxR-HTH	bacteria>actinobacteria	1
MODE-HTH+PBPII-><-Cluster1026_2clades<-?||?-><-?||?->SIG+ZNR+PspC*->?->Cluster186_3clades->?-><-ABC-ATPase<-SIG+TM(s)<-?<-XIS-HTH+T-OB	bacteria>acidobacteria	1
MODE-HTH+PBPII-><-PspC*	bacteria>actinobacteria	1
MODE-HTH+PBPII->SIG+PAP2->ABhydrolase-><-PspC+TM(s)+Toast-rack*||PspC+TM(s)+HISKIN*->REC+LuxR-HTH->	bacteria>actinobacteria	1
MODE-HTH+PBPII->tRNA->?-><-PspC*||TM-><-SIG+TM(s)	bacteria>actinobacteria	1
MuB-ATPase->?-><-Cluster357_4clades<-NtrC-AAA+FIS-HTH||?->PspA->PspB->PspC*->	bacteria>proteobacteria>alphaproteobacteria	1
NtrC-AAA+FIS-HTH->?->?->?->PspC*->PADR-HTH->PspC+LiaI-LiaF-TM*-><-?<-?||?->TetR-HTH->?->SIG+BLBD->SIG+TM(s)->	bacteria>fcb group	1
NUDIX->SUA->?->?-><-?<-?<-Mbetalac<-PspC(s)+LiaI-LiaF-TM+Toast-rack*<-PADR-HTH	bacteria>fcb group	1
NUDIX->TM-><-PspC*	bacteria>proteobacteria>alphaproteobacteria	1
O6MGT-HTH-><-LiaI-LiaF-TM+Toast-rack<-PspC+LiaI-LiaF-TM*	bacteria>fcb group	1
O6MGT-HTH->HhH-RADC->PspC+LiaI-LiaF-TM*->?->?->?->?->HMA+TM(s)->	bacteria>other unclassified bacteria	1
PADR-HTH->DUF1700-alpha-helical+PspC(s)+LiaI-LiaF-TM+Toast-rack*-><-?<-SIGMA-HTH	bacteria>fcb group	1
PADR-HTH->DUF1700-alpha-helical+PspC+LiaI-LiaF-TM+Toast-rack*->	bacteria>other unclassified bacteria	1
PADR-HTH->DUF1700-alpha-helical+PspC+LiaI-LiaF-TM+Toast-rack*->	NA	1
PADR-HTH->DUF1700-alpha-helical+PspC+LiaI-LiaF-TM+Toast-rack*->?->?->SIG+Toast-rack->	bacteria>fcb group	1
PADR-HTH->DUF1700-alpha-helical+PspC+LiaI-LiaF-TM+Toast-rack*-><-?<-PHP+ICAD+ComEA-HHH+N-OB	bacteria>fcb group	1
PADR-HTH->DUF1700-alpha-helical+PspC+LiaI-LiaF-TM+Toast-rack*-><-?||SIG+Toast-rack->Cluster65_2clades->?->?-><-TM	bacteria>fcb group	1
PADR-HTH->DUF1700-alpha-helical+PspC+LiaI-LiaF-TM+Toast-rack*-><-Cluster1055_2clades	bacteria>other unclassified bacteria	1
PADR-HTH->DUF1700-alpha-helical+PspC+LiaI-LiaF-TM+Toast-rack*->Cluster992_2clades->	bacteria>fcb group	1
PADR-HTH->DUF1700-alpha-helical+PspC+LiaI-LiaF-TM+Toast-rack*->SIG+Toast-rack-><-TM	bacteria>fcb group	1
PADR-HTH->DUF1700-alpha-helical+PspC+TM(s)+Toast-rack*->	bacteria>fcb group	1
PADR-HTH->DUF1700-alpha-helical+TM(s)->SIG+Toast-rack->PspC*->	bacteria>spirochaetes	1
PADR-HTH->PspC(s)+LiaI-LiaF-TM+Toast-rack(s)*-><-?||Mbetalac->	bacteria>fcb group	1
PADR-HTH->PspC(s)+LiaI-LiaF-TM+Toast-rack(s)*-><-HDRnase	bacteria>fcb group	1
PADR-HTH->PspC(s)+LiaI-LiaF-TM+Toast-rack(s)*-><-HDRnase<-SUA<-?||Cluster287_4clades->RnaseT2->	bacteria>fcb group	1
PADR-HTH->PspC(s)+LiaI-LiaF-TM+Toast-rack(s)*->SIG+Toast-rack->?->?->Cluster1273_2clades->Cluster166_3clades->	bacteria>fcb group	1
PADR-HTH->PspC(s)+LiaI-LiaF-TM+Toast-rack*->Mbetalac->	bacteria>fcb group	1
PADR-HTH->PspC+LiaI-LiaF-TM*->	bacteria>fcb group	1
PADR-HTH->PspC+LiaI-LiaF-TM*->?->?->Cluster753_2clades->	bacteria>other unclassified bacteria	1
PADR-HTH->PspC+LiaI-LiaF-TM+Toast-rack*->?->?-><-PEP-utilisers-C	bacteria>fcb group	1
PADR-HTH->PspC+TM(s)+Toast-rack*->ABC-ATPase->?-><-?||SGS->?->A18->	bacteria>other unclassified bacteria	1
PADR-HTH->Toast-rack->PspC*->	bacteria>firmicutes	1
PELOTA->?->tRNA->tRNA-><-LRP-HTH||?-><-?||PSE-><-PspC*<-?||Cluster85_4clades->	bacteria>actinobacteria	1
PELOTA->RnaseT2->?->PspC*-><-?||SIG+TM->	bacteria>other unclassified bacteria	1
PEP-utilisers-C->tRNA->SIG+TM(s)->ABC-ATPase->?-><-LiaI-LiaF-TM+Toast-rack<-PspC+LiaI-LiaF-TM*<-?<-Cluster85_4clades	bacteria>other unclassified bacteria	1
PEP-utilisers-N+PEP-utilisers(s)-C->?->PTSEIIC+TM+PTSEIIB(s)->?->PspC*->	bacteria>proteobacteria>betaproteobacteria	1
PRTase->PEP-utilisers-C-><-?<-?||tRNA->?->?-><-SIG+TM(s)<-PspC(s)*||TetR-HTH->ABC-ATPase->SIG+TM(s)->?->?-><-SIG+HAMP+HISKIN<-REC+LuxR-HTH	bacteria>deinococcus-thermus	1
PspA->?->PspC*->SIG+Toast-rack->	bacteria>spirochaetes	1
PspA->PspB->PspC*->?->?->?->?->?->?->Cluster39_2clades->	bacteria>proteobacteria>alphaproteobacteria	1
PspA->PspB->PspC*->?->?->?->?->Cluster1021_2clades->	bacteria>proteobacteria>alphaproteobacteria	1
PspA->PspB->PspC*->?->?->?->Cluster39_2clades->?-><-Cluster278_2clades	bacteria>proteobacteria>alphaproteobacteria	1
PspA->PspB->PspC*->?->?->Cluster39_2clades->?-><-Cluster278_2clades	bacteria>proteobacteria>alphaproteobacteria	1
PspA->PspB->PspC*->?->ENOYCOADEHYD->	bacteria>proteobacteria>gammaproteobacteria	1
PspA->PspB->PspC*->CR-ATPase1->TM(s)+IIGP1->ELM2->	bacteria>proteobacteria>gammaproteobacteria	1
PspA->PspB->PspC*->CR-ATPase1->TM(s)+IIGP1->NtrC-AAA+FIS-HTH->	bacteria>proteobacteria>gammaproteobacteria	1
PspA->PspB->PspC*->Phageshock_PspD->?->?->?->SIG+TM(s)->SIG+TM(s)->	bacteria>proteobacteria>gammaproteobacteria	1
PspA->PspB->PspC*->Phageshock_PspD->CR-ATPase1->	bacteria>proteobacteria>gammaproteobacteria	1
PspA->PspB->PspC*->Phageshock_PspD->CR-ATPase1->TM(s)+IIGP1->?->NtrC-AAA+FIS-HTH-><-?||Cluster65_2clades->	bacteria>proteobacteria>gammaproteobacteria	1
PspA->PspB->PspC*->Phageshock_PspD->SIG+RHOD-CDC25->	NA	1
PspA->PspB->PspC*->Phageshock_PspD->SIG+RHOD-CDC25->CR-ATPase1->TM(s)+IIGP1->?->NtrC-AAA+FIS-HTH->	bacteria>proteobacteria>gammaproteobacteria	1
PspA->PspB->PspC*->Phageshock_PspD->SIG+RHOD-CDC25->CR-ATPase1->TM(s)+IIGP1->NtrC-AAA+FIS-HTH->	bacteria>proteobacteria>gammaproteobacteria	1
PspA->PspB->PspC*->PSE->TM(s)+IIGP1->	bacteria>proteobacteria>gammaproteobacteria	1
PspA->PspB->PspC*->PspC*->	bacteria>proteobacteria>gammaproteobacteria	1
PspA->PspB->PspC*->PspC*->PspB-><-Cluster368_2clades	bacteria>proteobacteria>alphaproteobacteria	1
PspA->PspB->PspC*->SIG+BLBD->SIG+BLBD->SIG+TM(s)->Cluster131_2clades->	bacteria>proteobacteria>gammaproteobacteria	1
PspA->PspB->PspC*->SIG+BLBD->SIG+BLBD->SIG+TM(s)->Cluster131_2clades-><-STAT<-SIG+PhospholipaseD(s)	bacteria>proteobacteria>gammaproteobacteria	1
PspA->PspC*->?->?->?-><-?||Cluster39_2clades->	bacteria>proteobacteria>alphaproteobacteria	1
PspA->PspC*->PspA->SIG+TM+MORC->REC+LuxR-HTH-><-?<-?||?->Cluster73_4clades->	bacteria>firmicutes	1
PspB->PspC*->	bacteria>proteobacteria>gammaproteobacteria	1
PspB->PspC*->Cluster702_3clades-><-ABC-ATPase	bacteria>proteobacteria>gammaproteobacteria	1
PspB->PspC*->SIG+BLBD->SIG+BLBD->PSE->Cluster131_2clades->	bacteria>proteobacteria>gammaproteobacteria	1
PspB->PspC*->SIG+BLBD->SIG+BLBD->SIG+TM(s)->Cluster131_2clades->	bacteria>proteobacteria>gammaproteobacteria	1
PspB->PspC+PspB*->	bacteria>proteobacteria>deltaproteobacteria	1
PspC*->	bacteria>armatimonadetes	1
PspC*->	bacteria>proteobacteria>betaproteobacteria	1
PspC*->	bacteria>pvc group	1
PspC*->	bacteria>tenericutes	1
PspC*->?->?->?->?->Cluster791_2clades->	bacteria>proteobacteria>gammaproteobacteria	1
PspC*->?->?->?-><-?<-SIG+TM(s)+ABC-ATPase	bacteria>actinobacteria	1
PspC*->?->?->?->Cluster81_2clades->	bacteria>fcb group	1
PspC*->?->?->SbcC(s)+ABC-ATPase+SbcC->	bacteria>actinobacteria	1
PspC*->?->?->SIG+TM(s)->?->Cluster81_2clades->	bacteria>fcb group	1
PspC*->?->?->tRNA->Cluster95_4clades->ABC-ATPase->SIG+TM(s)->SIG+TM->	bacteria>other unclassified bacteria	1
PspC*->?-><-?<-?<-?<-Cluster719_2clades	bacteria>fcb group	1
PspC*->?-><-?<-PRTase	bacteria>fcb group	1
PspC*->?-><-?||Cluster327_2clades->	bacteria>actinobacteria	1
PspC*->?-><-?||PspC*-><-?<-?<-Cluster579_2clades	bacteria>fcb group	1
PspC*->?-><-TM<-SIGMA-HTH	bacteria>fcb group	1
PspC*->?-><-tRNA<-?<-?<-Ferredoxin-RRM<-?||SWIRM->Cluster186_3clades->	bacteria>actinobacteria	1
PspC*->?->Cluster221_3clades->	bacteria>actinobacteria	1
PspC*->?->Cluster771_2clades->	bacteria>actinobacteria	1
PspC*->?->MODE-HTH+PBPII->	bacteria>firmicutes	1
PspC*->?->SIG+TM(s)->?->Cluster81_2clades->	bacteria>fcb group	1
PspC*->?->SIG+TM(s)->?->Cluster81_2clades->Cluster293_2clades->	bacteria>fcb group	1
PspC*->?->SIG+TM(s)->SIG+TM(s)->?->LACI-HTH+PBPI->	bacteria>actinobacteria	1
PspC*->?->tRNA->?->?->SIG+HAMP+HISKIN->?->KOW->	bacteria>other unclassified bacteria	1
PspC*-><-?<-?<-?<-Cluster719_2clades	bacteria>fcb group	1
PspC*-><-?<-?<-HTH<-?<-?<-RNA-Helicase	bacteria>other unclassified bacteria	1
PspC*-><-?<-?<-SIG+HAMP+HISKIN<-REC+LuxR-HTH	bacteria>other unclassified bacteria	1
PspC*-><-?<-?<-SIG+TM(s)<-SIG+TM(s)	bacteria>firmicutes	1
PspC*-><-?<-?||?->?-><-MODE-HTH+PBPII	bacteria>actinobacteria	1
PspC*-><-?<-?||SIG+TM(s)->	bacteria>actinobacteria	1
PspC*-><-?<-ABC-ATPase	bacteria>actinobacteria	1
PspC*-><-?<-ABC-ATPase<-SIG+TM(s)<-SIG+TM(s)	bacteria>actinobacteria	1
PspC*-><-?<-Cluster469_2clades	bacteria>other unclassified bacteria	1
PspC*-><-?<-Cluster688_2clades	bacteria>actinobacteria	1
PspC*-><-?<-DDRP-ZNR+AT-HOOK-like+DDRP-betaprime+BBM2-DDRP+SBHM-DDRP(s)	bacteria>proteobacteria>alphaproteobacteria	1
PspC*-><-?<-GNTR-HTH	bacteria>actinobacteria	1
PspC*-><-?<-SIGMA-HTH	bacteria>chloroflexi	1
PspC*-><-?||?->?->?->Cluster166_3clades->	bacteria>fcb group	1
PspC*-><-?||ACT->	archaea>tack group	1
PspC*-><-?||DEOR-HTH+WYL(s)-C-><-Cluster398_2clades	bacteria>actinobacteria	1
PspC*-><-?||SIG+TM(s)-><-?||?->SIG+TM(s)->	bacteria>actinobacteria	1
PspC*-><-CHTH+DSBH	bacteria>firmicutes	1
PspC*-><-CHTH+DSBH||?->SIG+TM(s)->	bacteria>firmicutes	1
PspC*-><-Cluster1265_2clades||DEOR-HTH+WYL(s)-C-><-DDRP-ZNR+AT-HOOK-like+DDRP-betaprime+BBM2-DDRP+SBHM-DDRP(s)	bacteria>proteobacteria>alphaproteobacteria	1
PspC*-><-Cluster398_2clades	NA	1
PspC*-><-Cluster700_2clades<-Cluster1055_2clades<-?<-?<-?<-?||MODE-HTH+PBPII->	bacteria>firmicutes	1
PspC*-><-CS	bacteria>other unclassified bacteria	1
PspC*-><-MODE-HTH+PBPII	bacteria>actinobacteria	1
PspC*-><-PELOTA	bacteria>fcb group	1
PspC*-><-SIG+TM(s)||Cluster193_3clades->Cluster193_3clades->	bacteria>other unclassified bacteria	1
PspC*-><-ZNR	bacteria>other unclassified bacteria	1
PspC*->7TMR-HDED->SIG+TM(s)->EMAP->	bacteria>other unclassified bacteria	1
PspC*->Cluster186_3clades->?->RnaseT2->	bacteria>acidobacteria	1
PspC*->Cluster290_3clades->?->SAM-methylase->	bacteria>other unclassified bacteria	1
PspC*->Cluster948_2clades->	bacteria>actinobacteria	1
PspC*->ENOYCOADEHYD-><-?<-InPase	bacteria>actinobacteria	1
PspC*->LiaI-LiaF-TM+Toast-rack->	bacteria>other unclassified bacteria	1
PspC*->NUDIX->	bacteria>fcb group	1
PspC*->PADR-HTH->PspC*->	bacteria>fcb group	1
PspC*->PSE->LiaI-LiaF-TM+Toast-rack->	bacteria>fcb group	1
PspC*->PspA->	bacteria>firmicutes	1
PspC*->PspC*->	bacteria>actinobacteria	1
PspC*->PspC*-><-?||MODE-HTH+PBPII->	bacteria>firmicutes	1
PspC*->PspC+LiaI-LiaF-TM*->LiaI-LiaF-TM+Toast-rack->	bacteria>fcb group	1
PspC*->PspC+LiaI-LiaF-TM*->LiaI-LiaF-TM+Toast-rack-><-LACI-HTH+PBPI	bacteria>dictyoglomi	1
PspC*->PspC+LiaI-LiaF-TM*->SIG+TM(s)+Toast-rack->?-><-?<-?||RADICAL-SAM->	archaea>euryarchaeota	1
PspC*->RNA-Helicase+A18->	bacteria>fcb group	1
PspC*->SIG+TM(s)->	bacteria>other unclassified bacteria	1
PspC*->SIG+TM(s)->	bacteria>thermobaculum	1
PspC*->SIG+TM(s)+FTSK(s)-HTH->	bacteria>fcb group	1
PspC*->SIG+TM(s)+FTSK(s)-HTH->?->HMA+TM(s)->	bacteria>firmicutes	1
PspC*->SIG+Tox-TGase->	bacteria>other unclassified bacteria	1
PspC+LiaI-LiaF-TM*->	archaea>tack group	1
PspC+LiaI-LiaF-TM*->	bacteria>fcb group	1
PspC+LiaI-LiaF-TM*->?->?-><-?<-?<-?<-?||RADICAL-SAM->	archaea>euryarchaeota	1
PspC+LiaI-LiaF-TM*->?->?-><-?<-?<-?||RADICAL-SAM->	archaea>euryarchaeota	1
PspC+LiaI-LiaF-TM*->?->?-><-PSE<-?<-?||?->HhH-GPD->	bacteria>other unclassified bacteria	1
PspC+LiaI-LiaF-TM*->?->?->S2P+TM(s)->Cluster290_3clades->Cluster446_3clades->SCPB-HTH->	bacteria>firmicutes	1
PspC+LiaI-LiaF-TM*->?-><-?<-?<-?||ISOCOT->	bacteria>chloroflexi	1
PspC+LiaI-LiaF-TM*->?-><-?<-SIG+TM(s)+ABC-ATPase||?->?-><-HMA+TM(s)	bacteria>other unclassified bacteria	1
PspC+LiaI-LiaF-TM*->?->PSYN->	bacteria>other unclassified bacteria	1
PspC+LiaI-LiaF-TM*-><-?<-PRTase	bacteria>other unclassified bacteria	1
PspC+LiaI-LiaF-TM*-><-?||?->?->Cluster818_2clades-><-SIG+Tox-TGase<-DAGKIN<-Cluster964_2clades	bacteria>armatimonadetes	1
PspC+LiaI-LiaF-TM*-><-SIG+HAMP+HISKIN<-REC+LuxR-HTH	bacteria>thermotogae	1
PspC+LiaI-LiaF-TM*-><-SIG+TM(s)	bacteria>chloroflexi	1
PspC+LiaI-LiaF-TM*->LiaI-LiaF-TM+Toast-rack->	bacteria>thermotogae	1
PspC+LiaI-LiaF-TM*->LiaI-LiaF-TM+Toast-rack->?-><-?||tRNA-><-?<-?<-Cluster719_2clades	bacteria>other unclassified bacteria	1
PspC+LiaI-LiaF-TM*->LiaI-LiaF-TM+Toast-rack->?->S2P+TM(s)->Cluster290_3clades->Cluster446_3clades->SCPB-HTH->	bacteria>firmicutes	1
PspC+LiaI-LiaF-TM*->LiaI-LiaF-TM+Toast-rack-><-?<-?<-SIGMA-HTH	bacteria>fcb group	1
PspC+LiaI-LiaF-TM*->LiaI-LiaF-TM+Toast-rack-><-?||ABhydrolase-><-SIG+TM(s)	bacteria>fcb group	1
PspC+LiaI-LiaF-TM*->LiaI-LiaF-TM+Toast-rack-><-DAGKIN	bacteria>thermotogae	1
PspC+LiaI-LiaF-TM*->LiaI-LiaF-TM+Toast-rack-><-SIG+TM(s)	bacteria>firmicutes	1
PspC+LiaI-LiaF-TM*->LiaI-LiaF-TM+Toast-rack->Toast-rack->	bacteria>other unclassified bacteria	1
PspC+LiaI-LiaF-TM*->PSE->LiaI-LiaF-TM+Toast-rack->	bacteria>other unclassified bacteria	1
PspC+LiaI-LiaF-TM*->SIG+TM+Toast-rack->Mbetalac->	bacteria>other unclassified bacteria	1
PspC+TM(s)*->	bacteria>actinobacteria	1
PspC+TM(s)*->	bacteria>chloroflexi	1
PspC+TM(s)*-><-?||LACI-HTH+PBPI->ABC-ATPase->	bacteria>chloroflexi	1
PspC+TM(s)+HISKIN*->REC+LuxR-HTH->?-><-Cluster733_2clades	bacteria>actinobacteria	1
PspC+TM(s)+Toast-rack*->?-><-ABhydrolase	bacteria>actinobacteria	1
PspC+TM(s)+Toast-rack*->?->PspC+TM(s)+HISKIN*->REC+LuxR-HTH->	bacteria>actinobacteria	1
PspC+TM*->?->?->?->?->N-OB->?-><-LACI-HTH+PBPI	bacteria>firmicutes	1
PspC+TM*->?->ABC-ATPase->	bacteria>firmicutes	1
PTSEIIC+TM+PTSEIIB(s)->?->ABhydrolase-><-PspC+TM(s)+Toast-rack*||PspC+TM(s)+HISKIN*->REC+LuxR-HTH->	bacteria>actinobacteria	1
QTG->Cluster364_3clades-><-?<-?||MACRODOMAIN->?->?-><-PspC+LiaI-LiaF-TM+Toast-rack*<-PADR-HTH	bacteria>fcb group	1
REase->?->PspC*->?-><-?<-DEAM<-?||SIG+TM(s)+FTSK(s)-HTH->	bacteria>other unclassified bacteria	1
REC+LuxR-HTH->?-><-PspC*	bacteria>proteobacteria>alphaproteobacteria	1
REC+LuxR-HTH-><-?<-PspC+TM(s)+Toast-rack*<-PADR-HTH<-tRNA<-tRNA||Cluster539_2clades->?->?->?-><-PSE||?->Cluster1172_2clades->	bacteria>other unclassified bacteria	1
REC+LuxR-HTH-><-tRNA<-tRNA||?->SIG+TM(s)->PspC+LiaI-LiaF-TM*->	bacteria>chloroflexi	1
REC+LuxR-HTH->PspC*->	bacteria>other unclassified bacteria	1
REC+LuxR-HTH->SIG+HAMP+HISKIN->?->?->PspC*->	bacteria>other unclassified bacteria	1
REC+LuxR-HTH->SIG+HAMP+HISKIN->?->?->PspC*-><-?<-?||?->?-><-MODE-HTH+PBPII	bacteria>actinobacteria	1
RNA-Helicase->?->?-><-REC+LuxR-HTH<-PspC+TM(s)+HISKIN*||PspC+TM(s)+Toast-rack*->	bacteria>actinobacteria	1
RNA-Helicase->?->?->Cluster87_3clades->?->Cluster85_4clades->PspC*->	bacteria>other unclassified bacteria	1
RNA-Helicase->?->?->HTH->?->?-><-PspC*	bacteria>other unclassified bacteria	1
RNA-Helicase+A18->SbcC(s)+ABC-ATPase+SbcC->?->PspC*->SIG+TM(s)->?->?->?->Cluster87_3clades->TM->	bacteria>firmicutes	1
RNA-Helicase+A18->SbcC(s)+ABC-ATPase+SbcC->?->Toast-rack->PspC*->SIG+TM(s)->	bacteria>firmicutes	1
RNA-Helicase+A18->SbcC(s)+ABC-ATPase+SbcC->PspC*->SIG+TM(s)->	bacteria>firmicutes	1
RNA-Helicase+A18->SbcC(s)+ABC-ATPase+SbcC->Toast-rack->PspC*->SIG+TM(s)->	bacteria>firmicutes	1
RNA-Helicase+A18->SbcC(s)+ABC-ATPase+SbcC->Toast-rack->PspC*->SIG+TM(s)->?->?->?->Cluster87_3clades->TM->	bacteria>firmicutes	1
RnaseT2->?->PspC*->	bacteria>other unclassified bacteria	1
RnaseT2->?->PspC*-><-?<-?||SIG+TM->	bacteria>other unclassified bacteria	1
SbcC(s)+ABC-ATPase+SbcC->?->?->Toast-rack->PspC*->PspC*->SIG+TM(s)->	bacteria>firmicutes	1
sf+TM(s)->?->?->PspC*->	bacteria>proteobacteria>gammaproteobacteria	1
sGTP->tRNA->?->Cluster1065_2clades->Cluster221_3clades->?-><-PspC*	bacteria>fcb group	1
SIG+HAMP+HISKIN->?->?->?->ABC-ATPase->ABC-ATPase->?->PspC*->SIG+TM(s)->?->?->TM->	bacteria>firmicutes	1
SIG+PAP2->PspC*->	bacteria>firmicutes	1
SIG+PspC*->	bacteria>firmicutes	1
SIG+PspC+TM*->?->?->RNA-Helicase->	bacteria>other unclassified bacteria	1
SIG+PUA->?-><-?<-PspC*<-NUDIX	bacteria>other unclassified bacteria	1
SIG+SET-><-PspC*<-PADR-HTH	bacteria>pvc group	1
SIG+SMS-KaiC->?-><-LiaI-LiaF-TM+Toast-rack<-PspC+LiaI-LiaF-TM*||PurD-ATPgrasp->Cluster784_2clades-><-?<-?<-?<-SIG+Toast-rack	bacteria>deinococcus-thermus	1
SIG+TM->?->?->?-><-DUF1700-alpha-helical+PspC+LiaI-LiaF-TM*<-PADR-HTH	bacteria>fcb group	1
SIG+TM->?->ABC-ATPase->SIG+TM(s)->?->?-><-PspC*	bacteria>firmicutes	1
SIG+TM(s)->?->?->?->?->PspC*->	bacteria>other unclassified bacteria	1
SIG+TM(s)->?->?->?->ABC-ATPase->ABC-ATPase->?->PspC*->?->SIG+TM(s)->?->?->pPIWI->TM->Cluster215_2clades->	bacteria>firmicutes	1
SIG+TM(s)->?-><-PspC*	bacteria>actinobacteria	1
SIG+TM(s)-><-?<-?<-RNA-Helicase<-REC+LuxR-HTH<-PspC+TM(s)+HISKIN*||PspC+TM(s)*->	bacteria>actinobacteria	1
SIG+TM(s)-><-?<-?||?->PspC*->	bacteria>actinobacteria	1
SIG+TM(s)-><-?<-PspC+LiaI-LiaF-TM*<-SIG+TM(s)+ABC-ATPase	bacteria>firmicutes	1
SIG+TM(s)-><-?<-SIG+CW-binding-EndolysinC<-REC+LuxR-HTH<-SIG+TM+MORC<-?<-ABC-ATPase<-PspC*<-?<-PspC+TM(s)+Toast-rack*||PspC+TM(s)+HISKIN*->REC+LuxR-HTH->	bacteria>actinobacteria	1
SIG+TM(s)-><-?||?-><-?||?->?-><-?<-PspC*<-PspA	bacteria>proteobacteria>gammaproteobacteria	1
SIG+TM(s)-><-PspC*<-?<-PspC+TM(s)+Toast-rack*||PspC+TM(s)+HISKIN*->	bacteria>actinobacteria	1
SIG+TM(s)-><-TM||PspC*->	bacteria>actinobacteria	1
SIG+TM(s)->ABC-ATPase->?->?-><-DUF1700-alpha-helical+PspC+LiaI-LiaF-TM+Toast-rack*<-PADR-HTH	bacteria>fcb group	1
SIG+TM(s)->ABC-ATPase->Cluster1000_2clades->PspC+LiaI-LiaF-TM*->	bacteria>thermotogae	1
SIG+TM(s)->PspC*->	archaea>euryarchaeota	1
SIG+TM(s)->PspC*->	bacteria>proteobacteria>gammaproteobacteria	1
SIG+TM(s)->PspC*-><-SAM-methylase	archaea>euryarchaeota	1
SIG+TM(s)->PspC+LiaI-LiaF-TM*->	archaea>euryarchaeota	1
SIG+TM(s)->PspC+LiaI-LiaF-TM*->?->SIG+TM(s)->Cluster862_3clades->	archaea>euryarchaeota	1
SIG+TM(s)->SIG+TM(s)->?->?->?->PADR-HTH->DUF1700-alpha-helical+PspC+LiaI-LiaF-TM+Toast-rack*->	bacteria>fcb group	1
SIG+TM(s)->SIG+TM(s)->?-><-PspC*	bacteria>actinobacteria	1
SIG+TM(s)->SIG+TM(s)->?-><-PspC*||?->?->TM(s)->	bacteria>actinobacteria	1
SIG+TM(s)*-><-?<-?||?-><-ABC-ATPase	bacteria>actinobacteria	1
SIG+TM(s)+ABC-ATPase->?-><-PspC+LiaI-LiaF-TM*	bacteria>other unclassified bacteria	1
SIG+TM(s)+ABC-ATPase->SIG+TM(s)+ABC-ATPase->?->?-><-PspC*||?->?-><-?||?-><-SIG+HAMP+HISKIN||REC+LuxR-HTH->	bacteria>actinobacteria	1
SIG+TM(s)+ABC-ATPase->SIG+TM(s)+ABC-ATPase-><-?||?-><-PspC*	bacteria>firmicutes	1
SIG+TM(s)+ABC-ATPase->SIG+TM(s)+ABC-ATPase-><-PspC*	bacteria>firmicutes	1
SIG+TM(s)+Ferredoxin-RRM-><-PspC*	bacteria>firmicutes	1
SIG+TM(s)+Ferredoxin-RRM->PSE->?->PSE-><-PSE<-Cluster749_2clades||Cluster186_3clades->S2P+TM(s)->Cluster446_3clades->SCPB-HTH->PSE->PSE->PspC+LiaI-LiaF-TM*->	bacteria>armatimonadetes	1
SIG+Toast-rack-><-?<-?<-?<-DUF1700-alpha-helical+PspC+LiaI-LiaF-TM+Toast-rack*<-PADR-HTH	bacteria>fcb group	1
SIG+Toast-rack->PspC*->PspC*->MODE-HTH+PBPII->	bacteria>firmicutes	1
SIG+Toast-rack->SIG+Toast-rack*->SIG+TM(s)->ABC-ATPase->	bacteria>proteobacteria>alphaproteobacteria	1
SIGMA-HTH->?-><-?||?->?->?->ABhydrolase-><-PspC+TM(s)+Toast-rack*||PspC+TM(s)+HISKIN*->REC+LuxR-HTH->	bacteria>actinobacteria	1
SIGMA-HTH->?-><-?||?->?-><-SIG+TM(s)||ABhydrolase-><-PspC+TM(s)+Toast-rack*||PspC+TM(s)+HISKIN*->REC+LuxR-HTH->	bacteria>actinobacteria	1
SIGMA-HTH->?-><-CBS<-?||TetR-HTH->?->PspC*->	bacteria>actinobacteria	1
SIR2-><-LiaI-LiaF-TM+Toast-rack<-PspC+LiaI-LiaF-TM*	bacteria>firmicutes	1
SMS-KaiC->?->?->Cluster992_2clades->SMS-KaiC->?->PspC*->	bacteria>firmicutes	1
SMS-KaiC-><-PspC*	bacteria>firmicutes	1
SPOUT->Cluster857_2clades->?->?-><-?||?->PspC+LiaI-LiaF-TM*->LiaI-LiaF-TM+Toast-rack->	bacteria>other unclassified bacteria	1
STAT-><-?<-?<-Cluster131_2clades<-SIG+TM(s)<-SIG+BLBD<-SIG+BLBD<-PspC*<-PspB<-PspA	bacteria>proteobacteria>gammaproteobacteria	1
TM->?->?->?->?->Cluster1063_2clades-><-PspC+TM(s)+Toast-rack*||PspC+TM(s)+HISKIN*->REC+LuxR-HTH->	bacteria>actinobacteria	1
TM->?-><-?<-?<-?||?-><-?<-PspC+TM(s)+Toast-rack*||?->PspC+TM(s)+HISKIN*->REC+LuxR-HTH->	bacteria>actinobacteria	1
TM->?-><-?||?->?-><-?||Cluster73_4clades-><-PspC*<-?<-SIG+TM(s)||MODE-HTH+PBPII-><-ABhydrolase||?-><-DEAM	bacteria>actinobacteria	1
TM->?->PspC(s)*->	bacteria>other unclassified bacteria	1
TM-><-?<-SIG+Toast-rack<-DUF1700-alpha-helical+PspC+LiaI-LiaF-TM+Toast-rack*<-PADR-HTH	bacteria>fcb group	1
TM-><-?<-TM(s)+IIGP1<-CR-ATPase1<-PspC*<-PspB<-PspA	bacteria>proteobacteria>gammaproteobacteria	1
TM-><-Cluster539_2clades||?->?->PspC*->	bacteria>actinobacteria	1
TM-><-PspC*<-?<-?<-?<-?<-Cluster552_2clades<-Cluster287_4clades	bacteria>actinobacteria	1
TM-><-PspC*<-?<-?<-PspB<-PspB	bacteria>other unclassified bacteria	1
TM-><-SIG+TM(s)<-?<-?<-PspC+TM(s)+Toast-rack*||PspC+TM(s)+HISKIN*->REC+LuxR-HTH-><-?<-ABC-ATPase	bacteria>actinobacteria	1
TM-><-SIG+Toast-rack<-SIG+Toast-rack<-?<-DUF1700-alpha-helical+PspC+LiaI-LiaF-TM+Toast-rack*<-PADR-HTH	bacteria>fcb group	1
TM-><-SIG+Toast-rack<-SIG+Toast-rack<-DUF1700-alpha-helical+PspC+LiaI-LiaF-TM+Toast-rack*<-PADR-HTH	bacteria>fcb group	1
TM-><-SIG+Toast-rack<-SIG+Toast-rack<-DUF1700-alpha-helical+PspC+LiaI-LiaF-TM+Toast-rack*<-PADR-HTH	NA	1
TM-><-SIG+Toast-rack||?-><-?<-DUF1700-alpha-helical+PspC+LiaI-LiaF-TM+Toast-rack*<-PADR-HTH	bacteria>fcb group	1
TM->Cluster221_3clades-><-PspC*	bacteria>fcb group	1
TM(s)->?->?->?->?->?-><-PspC*	bacteria>firmicutes	1
TM(s)->?->?->?->?->?-><-PspC*||?->?-><-?||?->?-><-Cluster818_2clades	bacteria>firmicutes	1
TM(s)-><-TM<-Cluster37_3clades<-pPIWI<-?<-?<-SIG+TM(s)<-PspC*<-Toast-rack	bacteria>firmicutes	1
TM(s)->PspC*->	bacteria>actinobacteria	1
TM(s)->SIG+TM(s)+CBS->PspC+LiaI-LiaF-TM+Toast-rack*->PspC*->	bacteria>actinobacteria	1
TM(s)+PspC*->tRNA-><-?<-?<-SIG+NarQ+PhospholipaseD	bacteria>fcb group	1
Toast-rack->PspC*->	bacteria>firmicutes	1
Toast-rack->PspC*->?->SIG+TM(s)->?->?->pPIWI->?->TM->	bacteria>firmicutes	1
Toast-rack->PspC*->SIG+TM(s)-><-SIG+TM(s)	bacteria>firmicutes	1
Toast-rack->PspC+Toast-rack*->PspC*->SIG+TM(s)->	bacteria>firmicutes	1
UDG->?-><-LiaI-LiaF-TM+Toast-rack<-LiaI-LiaF-TM+Toast-rack<-PspC*	bacteria>other unclassified bacteria	1
XIS-HTH+T-OB->?->SIG+TM(s)->ABC-ATPase->PspC*->?-><-LDcluster4	bacteria>actinobacteria	1
ZNR-><-?<-PspC*<-PspB<-PspA	bacteria>proteobacteria>gammaproteobacteria	1
