GenContext.norep	Lineage.final	count
CheC->REC->SIG+TM->SIG+TM(s)->SIG+TM->SIG+TM(s)->TM(s)->SIG+TM(s)*->SIG+APATPase->ParA-Soj-PloopNTPase->REC->HPT+HISKIN+CheW->CheW->CheC->CheD->	bacteria>firmicutes	72
<-REC<-HPT+HISKIN+CheW<-SFII-RAD3<-REC<-SIGMA-HTH<-ParA-Soj-PloopNTPase<-SIG+APATPase<-SIG+TM(s)*	bacteria>proteobacteria>gammaproteobacteria	70
<-SIG+TM<-SIG+TM(s)*<-TM(s)	bacteria>proteobacteria>gammaproteobacteria	64
SIG+TM*->?->LiaI-LiaF-TM+Toast-rack*->?->REC->	bacteria>firmicutes	51
TM(s)->SIG+TM(s)*->SIG+TM->	bacteria>proteobacteria>gammaproteobacteria	45
TM(s)->SIG+TM(s)*->SIG+APATPase->ParA-Soj-PloopNTPase->SIGMA-HTH->	bacteria>proteobacteria>betaproteobacteria	44
SIG+TM(s)*->SIG+APATPase->ParA-Soj-PloopNTPase->SIGMA-HTH->REC->SFII-RAD3->HPT+HISKIN+CheW->REC->	bacteria>proteobacteria>gammaproteobacteria	43
<-CheD<-CheC<-CheW<-HPT+HISKIN+CheW<-REC<-ParA-Soj-PloopNTPase<-SIG+APATPase<-SIG+TM(s)*<-TM(s)<-SIG+TM(s)<-SIG+TM<-SIG+TM(s)<-SIG+TM<-REC<-CheC	bacteria>firmicutes	41
SIG+TM(s)*->SIG+TM(s)->	bacteria>proteobacteria>alphaproteobacteria	41
CheC->CheC->SIG+TM->SIG+TM(s)->SIG+TM->SIG+TM(s)->TM(s)->SIG+TM(s)*->SIG+APATPase->ParA-Soj-PloopNTPase->SIGMA-HTH->REC->SFII-RAD3->HPT+HISKIN+CheW->REC->	bacteria>proteobacteria>gammaproteobacteria	36
PADR-HTH->DUF1700-alpha-helical+PspC+LiaI-LiaF-TM+Toast-rack*->	bacteria>fcb group	35
CheC->CheC->SIG+TM(s)->SIG+TM->SIG+TM(s)->TM(s)->SIG+TM(s)*->	bacteria>proteobacteria>gammaproteobacteria	32
SIG+TM(s)*->	bacteria>proteobacteria>alphaproteobacteria	32
<-REC<-?<-LiaI-LiaF-TM+Toast-rack*<-?<-?<-LiaI-LiaF-TM*	bacteria>firmicutes	30
<-SIG+TM(s)*	bacteria>proteobacteria>epsilonproteobacteria	30
SIG+BetaPropeller->?->?->?->?->IONCHANNEL->SIG+TM->SIG+TM(s)*->SIG+TM(s)->	bacteria>proteobacteria>alphaproteobacteria	28
<-DUF1700-alpha-helical+PspC+LiaI-LiaF-TM+Toast-rack*<-PADR-HTH	bacteria>fcb group	27
<-SIG+TM(s)*	bacteria>proteobacteria>alphaproteobacteria	27
<-SIG+TM(s)*<-TM(s)	bacteria>pvc group	26
<-SIG+TM(s)*<-TM(s)<-SIG+TM(s)<-SIG+TM<-SIG+TM(s)<-CheC<-CheC	bacteria>proteobacteria>gammaproteobacteria	26
SIG+TM(s)*->SIG+APATPase->ParA-Soj-PloopNTPase->SIGMA-HTH->	bacteria>proteobacteria>gammaproteobacteria	26
TM(s)->SIG+TM(s)*->	bacteria>proteobacteria>gammaproteobacteria	26
<-REC<-?<-LiaI-LiaF-TM+Toast-rack*<-?<-SIG+TM*	bacteria>firmicutes	24
<-SIGMA-HTH<-ParA-Soj-PloopNTPase<-SIG+APATPase<-SIG+TM(s)*<-TM(s)	bacteria>proteobacteria>betaproteobacteria	24
<-Cluster108_2clades<-?<-?<-FilH<-?<-ParA-Soj-PloopNTPase<-SIG+APATPase<-SIG+TM(s)*<-TM(s)<-SIG+TM(s)<-SIG+TM<-SIG+TM(s)<-SIG+TM<-CheC<-CheC	bacteria>spirochaetes	23
<-TPR<-?<-?<-?<-SIG+TM(s)*<-TPR<-?<-CR-REase10<-?<-CR-ATPase7	bacteria>proteobacteria>gammaproteobacteria	22
<-SIG+TM(s)*<-TM(s)	bacteria>proteobacteria>gammaproteobacteria	21
<-SIG+TM<-?<-?<-?<-Cluster27_3clades<-SIG+TM<-SIG+TM(s)*	bacteria>proteobacteria>betaproteobacteria	21
<-SIG+TM<-SIG+TM(s)<-Cluster24_2clades<-Cluster39_2clades<-SIG+TM(s)*<-TM(s)	bacteria>proteobacteria>betaproteobacteria	21
LiaI-LiaF-TM+Toast-rack*->?->REC->	bacteria>firmicutes	21
<-SIG+TM(s)<-SIG+TM(s)*	bacteria>proteobacteria>alphaproteobacteria	19
<-CheC<-CheW<-HPT+HISKIN+CheW<-REC<-PilZ<-ParA-Soj-PloopNTPase<-SIG+APATPase<-SIG+TM(s)*<-TM(s)<-SIG+TM(s)<-SIG+TM<-SIG+TM(s)<-SIG+TM<-REC<-CheC	bacteria>firmicutes	18
<-REC<-HPT+HISKIN+CheW<-SFII-RAD3<-REC<-SIGMA-HTH<-ParA-Soj-PloopNTPase<-SIG+APATPase<-SIG+TM(s)*<-TM(s)<-SIG+TM(s)<-SIG+TM<-SIG+TM(s)<-SIG+TM<-CheC<-CheC	bacteria>proteobacteria>gammaproteobacteria	18
<-SIGMA-HTH<-ParA-Soj-PloopNTPase<-SIG+APATPase<-SIG+TM(s)*	bacteria>proteobacteria>gammaproteobacteria	17
<-SIG+TM(s)*<-TM(s)	bacteria>proteobacteria>betaproteobacteria	15
<-SIG+TM(s)<-SIG+TM(s)*<-SIG+TM<-IONCHANNEL<-?<-?<-?<-?<-SIG+BetaPropeller	bacteria>proteobacteria>alphaproteobacteria	15
TM(s)->SIG+TM(s)*->	bacteria>proteobacteria>betaproteobacteria	15
<-PspC<-?<-LiaI-LiaF-TM*	bacteria>firmicutes	14
<-SIG+TM<-SIG+TM(s)<-Cluster63_2clades<-?<-TET-TPase<-NACHT<-FHA<-SIG+TM(s)*<-CR-ATPase7	bacteria>proteobacteria>gammaproteobacteria	14
CR-ATPase7->SIG+TM(s)*->FHA->NACHT->TET-TPase->?->Cluster63_2clades->SIG+TM(s)->SIG+TM->	bacteria>proteobacteria>gammaproteobacteria	14
NACHT->?->SIG+TM(s)->SIG+TM->SIG+TM(s)->TM(s)-><-?<-SIG+TM(s)*	bacteria>proteobacteria>alphaproteobacteria	13
TM(s)->SIG+TM(s)*->Cluster39_2clades->Cluster24_2clades->SIG+TM(s)->SIG+TM->?->FHA->	bacteria>proteobacteria>gammaproteobacteria	13
<-SIG+TM(s)*||TM+OmpA->	bacteria>proteobacteria>gammaproteobacteria	12
<-SIG+TM<-SIG+TM(s)<-Cluster24_2clades<-?<-Cluster59_2clades<-NACHT<-Cluster49_2clades<-SIG+TM(s)*<-PYRIN<-Cluster27_3clades<-AraC-HTH	bacteria>proteobacteria>gammaproteobacteria	12
AraC-HTH->Cluster27_3clades->PYRIN->SIG+TM(s)*->Cluster49_2clades->NACHT->Cluster59_2clades->?->Cluster24_2clades->SIG+TM(s)->SIG+TM->	bacteria>proteobacteria>gammaproteobacteria	12
SIG+TM(s)*->SIG+TM->Cluster27_3clades->?->?->?->SIG+TM->	bacteria>proteobacteria>betaproteobacteria	12
<-DUF1700-alpha-helical+PspC+LiaI-LiaF-TM*<-PADR-HTH	bacteria>fcb group	11
<-FHA<-?<-SIG+TM<-SIG+TM(s)<-Cluster24_2clades<-Cluster39_2clades<-SIG+TM(s)*<-TM(s)	bacteria>proteobacteria>gammaproteobacteria	11
SIG+TM(s)->SIG+TM->SIG+TM(s)->TM(s)->SIG+TM(s)*->SIG+APATPase->SIG+BetaPropeller->CheRN-Alpha+CheR-Methylase->?->SIG+TM(s)->TM+OmpA->	bacteria>firmicutes	11
SIG+TM(s)*->SIG+TM(s)->TM(s)->?-><-?<-TM<-SIG+SAF<-SIG+BetaPropeller	bacteria>proteobacteria>alphaproteobacteria	11
TM(s)->SIG+TM(s)*->	bacteria>pvc group	11
TM(s)->SIG+TM(s)*->SIG+APATPase->?->SIGMA-HTH->	bacteria>proteobacteria>betaproteobacteria	11
<-LiaI-LiaF-TM+Toast-rack*	bacteria>firmicutes	10
<-SIG+TM(s)*<-TPR<-?<-CR-REase10<-CR-ATPase7	bacteria>proteobacteria>betaproteobacteria	10
<-SIGMA-HTH<-SIG+TM(s)*	bacteria>proteobacteria>alphaproteobacteria	10
CR-ATPase7->?->CR-REase10->?->TPR->SIG+TM(s)*->?->?->?->TPR->	bacteria>proteobacteria>gammaproteobacteria	10
SIG+TM(s)*->SIGMA-HTH->	bacteria>proteobacteria>alphaproteobacteria	10
<-PspC(s)+LiaI-LiaF-TM+Toast-rack(s)*<-PADR-HTH	bacteria>fcb group	9
<-SIG+TM(s)*<-TM(s)<-SIG+TM(s)<-SIG+TM<-SIG+TM(s)<-CheC<-CheC	bacteria>proteobacteria>betaproteobacteria	9
CheC->CheC->?->SIG+TM(s)->SIG+TM->SIG+TM(s)->TM(s)->SIG+TM(s)*->SIG+APATPase->SIG+BetaPropeller->	bacteria>firmicutes	9
LiaI-LiaF-TM+Toast-rack*->	bacteria>firmicutes	9
LiaI-LiaF-TM+Toast-rack*->REC->	bacteria>fcb group	9
PADR-HTH->DUF1700-alpha-helical+PspC+LiaI-LiaF-TM*->	bacteria>other unclassified bacteria	9
TM(s)->SIG+TM(s)*->Cluster39_2clades->Cluster24_2clades->SIG+TM(s)->SIG+TM->?->FHA->	bacteria>proteobacteria>betaproteobacteria	9
TM(s)->SIG+TM(s)*->SIG+APATPase-><-DICT<-Cluster40_2clades<-SIG+SAF	bacteria>proteobacteria>betaproteobacteria	9
<-SIG+BetaPropeller<-?<-?<-SIGMA-HTH<-PilZ<-ParA-Soj-PloopNTPase<-SIG+APATPase<-SIG+TM(s)*<-TM(s)<-SIG+TM<-SIG+TM(s)<-SIG+TM<-TM<-TM+OmpA<-SIG+TM(s)	bacteria>firmicutes	8
<-SIG+TM<-SIG+TM(s)<-Cluster24_2clades<-?<-?<-NACHT<-Cluster49_2clades<-SIG+TM(s)*<-PYRIN<-Cluster27_3clades<-AraC-HTH	bacteria>proteobacteria>betaproteobacteria	8
CheC->REC->SIG+TM->SIG+TM(s)->SIG+TM->SIG+TM(s)->TM(s)->SIG+TM(s)*->SIG+APATPase->ParA-Soj-PloopNTPase->PilZ->REC->HPT+HISKIN+CheW->CheW->CheC->	bacteria>firmicutes	8
SIG+TM(s)*->	bacteria>proteobacteria>gammaproteobacteria	8
SIG+TM(s)*->SIG+TM(s)->TM(s)->	bacteria>proteobacteria>alphaproteobacteria	8
TM(s)->SIG+TM(s)*->SIG+APATPase->	bacteria>proteobacteria>betaproteobacteria	8
<-SIG+TM(s)*<-TM(s)<-SIG+TM(s)<-SIG+TM<-SIG+TM(s)	bacteria>proteobacteria>deltaproteobacteria	7
<-SIG+TM(s)*<-TM(s)<-SIG+TM(s)<-SIG+TM<-SIG+TM(s)<-SIG+TM<-CheC<-CheC	bacteria>actinobacteria	7
<-SIG+TM(s)<-CheC<-Cluster63_2clades<-?<-TET-TPase<-NACHT<-FHA<-SIG+TM(s)*<-CR-ATPase7	bacteria>proteobacteria>gammaproteobacteria	7
AraC-HTH->Cluster27_3clades->PYRIN->SIG+TM(s)*->Cluster49_2clades->NACHT->?->?->Cluster24_2clades->SIG+TM(s)->SIG+TM->	bacteria>proteobacteria>betaproteobacteria	7
CheC->CheC->SIG+TM(s)->SIG+TM->SIG+TM(s)->TM(s)->SIG+TM(s)*->	bacteria>proteobacteria>betaproteobacteria	7
CheC->REC->SIG+TM->SIG+TM(s)->SIG+TM->SIG+TM(s)->TM(s)->SIG+TM(s)*->SIG+APATPase->ParA-Soj-PloopNTPase->PilZ->HPT+HISKIN+CheW->CheW->CheC->CheD->	bacteria>firmicutes	7
ISOCOT->SIG+TM(s)->TM(s)->SIG+TM(s)*->SIG+APATPase->ParA-Soj-PloopNTPase->PilZ->CheC->CheD->SIGMA-HTH->	bacteria>thermotogae	7
LiaI-LiaF-TM*->?->?->LiaI-LiaF-TM+Toast-rack*->?->REC->	bacteria>firmicutes	7
SIG+TM(s)*->SIG+APATPase->ParA-Soj-PloopNTPase->SIGMA-HTH->	bacteria>proteobacteria>betaproteobacteria	7
TM(s)->SIG+TM(s)*->Cluster39_2clades->Cluster24_2clades->SIG+TM(s)->SIG+TM->	bacteria>proteobacteria>betaproteobacteria	7
TM(s)->SIG+TM(s)*->SIG+APATPase->ParA-Soj-PloopNTPase->SIGMA-HTH->SIG+TM(s)->TM+OmpA-><-DICT<-Cluster40_2clades	bacteria>proteobacteria>betaproteobacteria	7
TM(s)->SIG+TM(s)*->SIG+TM-><-DICT<-Cluster40_2clades<-SIG+SAF	bacteria>proteobacteria>gammaproteobacteria	7
<-?*	bacteria>other unclassified bacteria	6
<-CheD<-CheC<-CheW<-HPT+HISKIN+CheW<-PilZ<-ParA-Soj-PloopNTPase<-SIG+APATPase<-SIG+TM(s)*<-TM(s)<-SIG+TM(s)<-SIG+TM<-SIG+TM(s)<-SIG+TM<-REC<-CheC	bacteria>firmicutes	6
<-Cluster27_3clades<-SIG+TM<-SIG+TM(s)*	bacteria>proteobacteria>betaproteobacteria	6
<-FHA<-?<-SIG+TM<-SIG+TM(s)<-Cluster24_2clades<-Cluster39_2clades<-SIG+TM(s)*<-TM(s)	bacteria>proteobacteria>betaproteobacteria	6
<-REC<-?<-?<-?<-PspC<-?<-LiaI-LiaF-TM*	bacteria>firmicutes	6
<-REC<-?<-LiaI-LiaF-TM+Toast-rack*	bacteria>firmicutes	6
<-SIG+BetaPropeller<-?<-?<-SIGMA-HTH<-PilZ<-ParA-Soj-PloopNTPase<-SIG+APATPase<-SIG+TM(s)*<-TM(s)<-SIG+TM<-SIG+TM(s)<-SIG+TM<-TM<-?<-SIG+BetaPropeller	bacteria>firmicutes	6
<-SIG+TM(s)*	bacteria>proteobacteria>deltaproteobacteria	6
<-SIGMA-HTH<-ParA-Soj-PloopNTPase<-SIG+APATPase<-SIG+TM(s)*<-TM(s)<-SIG+TM(s)<-SIG+TM<-SIG+TM(s)<-SIG+TM<-CheC<-CheC	bacteria>proteobacteria>deltaproteobacteria	6
CheC->CheC->SIG+TM->SIG+TM(s)->SIG+TM->SIG+TM(s)->TM(s)->SIG+TM(s)*->SIG+APATPase->ParA-Soj-PloopNTPase->SIGMA-HTH->	bacteria>proteobacteria>gammaproteobacteria	6
CheRN-Alpha+CheR-Methylase->REC->REC->SFII-RAD3->TM(s)->SIG+TM(s)*->SIG+TM->	bacteria>proteobacteria>gammaproteobacteria	6
PADR-HTH->DUF1700-alpha-helical+PspC+LiaI-LiaF-TM*->	bacteria>fcb group	6
PADR-HTH->PspC+LiaI-LiaF-TM+Toast-rack*->	bacteria>other unclassified bacteria	6
SIG+SAF->Cluster40_2clades->DICT-><-SIG+TM<-SIG+TM(s)*<-TM(s)	bacteria>proteobacteria>gammaproteobacteria	6
TM(s)->SIG+TM(s)*->SIG+APATPase->ParA-Soj-PloopNTPase->SIGMA-HTH->SIG+TM->	bacteria>proteobacteria>betaproteobacteria	6
TM(s)->SIG+TM(s)*->SIG+TM-><-DICT<-Cluster40_2clades	bacteria>proteobacteria>gammaproteobacteria	6
?*->	bacteria>firmicutes	5
?*->	bacteria>other unclassified bacteria	5
<-?*	bacteria>firmicutes	5
<-Cluster103_2clades<-Cluster179_2clades<-TET-TPase<-NACHT<-SIG+TM(s)*<-Cluster57_2clades	bacteria>proteobacteria>gammaproteobacteria	5
<-Cluster288_2clades<-?<-?<-PspC+LiaI-LiaF-TM+Toast-rack*<-PADR-HTH	bacteria>other unclassified bacteria	5
<-LiaI-LiaF-TM+Toast-rack*	bacteria>other unclassified bacteria	5
<-SIG+BetaPropeller<-?<-?<-SIGMA-HTH<-PilZ<-ParA-Soj-PloopNTPase<-SIG+APATPase<-SIG+TM(s)*<-TM(s)<-SIG+TM<-SIG+TM(s)<-SIG+TM<-TM	bacteria>firmicutes	5
<-SIG+BetaPropeller<-SIG+APATPase<-SIG+TM(s)*<-TM(s)<-SIG+TM(s)<-SIG+TM<-SIG+TM(s)<-?<-CheC<-CheC	bacteria>firmicutes	5
<-SIG+TM(s)*	bacteria>proteobacteria>gammaproteobacteria	5
<-SIG+TM(s)*<-TM(s)<-SIG+MHYT+TM(s)+GGDEF+EAL	bacteria>proteobacteria>gammaproteobacteria	5
<-SIG+TM(s)*<-TM(s)<-SIG+TM(s)<-SIG+TM	bacteria>proteobacteria>gammaproteobacteria	5
<-SIG+TM(s)<-SIG+TM(s)*<-?<-SIG+TM<-IONCHANNEL	bacteria>proteobacteria>alphaproteobacteria	5
<-SIGMA-HTH<-?<-CheD<-CheC<-PilZ<-ParA-Soj-PloopNTPase<-SIG+APATPase<-SIG+TM(s)*<-TM(s)<-SIG+TM(s)<-SIG+TM<-SIG+TM(s)<-SIG+TM<-REC<-CheC	bacteria>firmicutes	5
<-SIGMA-HTH<-?<-SIG+APATPase<-SIG+TM(s)*<-TM(s)	bacteria>proteobacteria>betaproteobacteria	5
<-SIGMA-HTH<-CheD<-CheC<-CheW<-HPT+HISKIN+CheW<-ParA-Soj-PloopNTPase<-SIG+APATPase<-SIG+TM(s)*<-TM(s)<-SIG+TM(s)<-SIG+TM<-SIG+TM(s)<-SIG+TM<-REC<-CheC	bacteria>firmicutes	5
<-SIGMA-HTH<-CheD<-CheW<-HPT+HISKIN+CheW<-REC<-ParA-Soj-PloopNTPase<-SIG+APATPase<-SIG+TM(s)*<-TM(s)<-SIG+TM(s)<-SIG+TM<-SIG+TM(s)<-SIG+TM<-REC<-CheC	bacteria>firmicutes	5
<-TM+OmpA||SIG+TM(s)*->	bacteria>proteobacteria>gammaproteobacteria	5
<-TM+OmpA<-SIG+TM(s)<-SIGMA-HTH<-ParA-Soj-PloopNTPase<-SIG+APATPase<-SIG+TM(s)*<-TM(s)<-SIG+TM(s)<-SIG+TM<-SIG+TM(s)<-SIG+TM<-CheC<-CheC	bacteria>proteobacteria>gammaproteobacteria	5
<-TM<-SIG+SAF<-SIG+BetaPropeller<-SIG+BetaPropeller<-SIGMA-HTH<-ParA-Soj-PloopNTPase<-SIG+APATPase<-SIG+TM(s)*	bacteria>proteobacteria>deltaproteobacteria	5
ABC-ATPase->?->tRNA-><-?||?->?->?->?->SIG+TM(s)*->SIG+APATPase->ParA-Soj-PloopNTPase->?-><-Cluster302_2clades<-ClpABN-AAA+SLATT+ClpABC-AAA	bacteria>aquificae	5
AraC-HTH->Cluster27_3clades->PYRIN->SIG+TM(s)*->Cluster49_2clades->NACHT->?->?->Cluster24_2clades->SIG+TM(s)->SIG+TM->	bacteria>proteobacteria>gammaproteobacteria	5
CheC->SIG+TM(s)->SIG+TM->SIG+TM(s)->TM(s)->SIG+TM(s)*->	bacteria>proteobacteria>gammaproteobacteria	5
LiaI-LiaF-TM*->?->PspC->	bacteria>firmicutes	5
PADR-HTH->PspC+LiaI-LiaF-TM+Toast-rack*->	bacteria>fcb group	5
SIG+BetaPropeller->?->?->?->?->IONCHANNEL->SIG+TM->SIG+TM(s)*->SIG+TM(s)->?->?->?->?-><-REC	bacteria>proteobacteria>alphaproteobacteria	5
SIG+MHYT+TM(s)+GGDEF+EAL->TM(s)->SIG+TM(s)*->	bacteria>proteobacteria>gammaproteobacteria	5
SIG+TM->?->?->?->Cluster57_2clades->SIG+TM(s)*->NACHT->TET-TPase->?->?->SIG+TM(s)->SIG+TM->SIG+TM(s)->	bacteria>proteobacteria>gammaproteobacteria	5
SIG+TM(s)->TM(s)->SIG+TM(s)*->SIG+APATPase->ParA-Soj-PloopNTPase->SIGMA-HTH->REC->TM->	bacteria>proteobacteria>deltaproteobacteria	5
SIG+TM(s)*->	bacteria>proteobacteria>betaproteobacteria	5
SIG+TM(s)*->	bacteria>proteobacteria>deltaproteobacteria	5
SIG+TM(s)*->	bacteria>proteobacteria>epsilonproteobacteria	5
SIG+TM(s)+AMIN*->SIGMA-HTH->	bacteria>pvc group	5
TM->CheC->SIG+TM->SIG+TM(s)->SIG+TM->SIG+TM(s)->TM(s)->SIG+TM(s)*->SIG+APATPase->ParA-Soj-PloopNTPase->PilZ->SIGMA-HTH->?->?->SIG+BetaPropeller->	bacteria>firmicutes	5
TM(s)->SIG+TM(s)*->Cluster39_2clades->	bacteria>proteobacteria>betaproteobacteria	5
?*->	bacteria>actinobacteria	4
<-CheD<-SIG+BetaPropeller<-SIG+BetaPropeller<-SIGMA-HTH<-PilZ<-ParA-Soj-PloopNTPase<-SIG+APATPase<-SIG+TM(s)*<-TM(s)<-SIG+TM(s)<-SIG+TM<-SIG+TM(s)<-SIG+TM<-CheC<-TM	bacteria>firmicutes	4
<-ParA-Soj-PloopNTPase<-SIG+APATPase<-SIG+TM(s)*<-SIG+NtrC-AAA+FIS-HTH<-SIG+TM(s)<-CheC<-?<-SIG+TM	bacteria>proteobacteria>alphaproteobacteria	4
<-PspC+LiaI-LiaF-TM+Toast-rack*<-PADR-HTH	bacteria>fcb group	4
<-REC<-?<-SIG+TM(s)+Toast-rack*<-?<-SIG+TM*	bacteria>firmicutes	4
<-REC<-LiaI-LiaF-TM+Toast-rack*	bacteria>fcb group	4
<-REC<-SIG+TM(s)<-?<-LiaI-LiaF-TM+Toast-rack*	bacteria>fcb group	4
<-SFII-RAD3<-REC<-SIGMA-HTH<-ParA-Soj-PloopNTPase<-SIG+APATPase<-SIG+TM(s)*<-?<-?<-TM(s)<-SIG+TM(s)<-SIG+TM<-SIG+TM(s)<-SIG+TM	bacteria>proteobacteria>gammaproteobacteria	4
<-SIG+TM(s)*	bacteria>other proteobacteria	4
<-SIG+TM(s)*<-SIG+NtrC-AAA+FIS-HTH<-CheC<-?<-CheC<-SIG+TM	bacteria>proteobacteria>alphaproteobacteria	4
<-SIG+TM(s)<-SIG+TM(s)*||?-><-SIG+TM<-IONCHANNEL	bacteria>proteobacteria>alphaproteobacteria	4
<-SIG+TM(s)<-SIG+TM<-SIG+TM(s)<-?<-?<-TET-TPase<-NACHT<-SIG+TM(s)*	bacteria>proteobacteria>gammaproteobacteria	4
<-SIG+TM(s)<-SIG+TM<-SIG+TM(s)<-?<-?<-TET-TPase<-NACHT<-SIG+TM(s)*<-Cluster57_2clades<-?<-?<-?<-SIG+TM	bacteria>proteobacteria>gammaproteobacteria	4
<-SIG+TM<-SIG+TM(s)*<-TM(s)<-SFII-RAD3<-REC<-REC<-CheRN-Alpha+CheR-Methylase	bacteria>proteobacteria>gammaproteobacteria	4
<-SIGMA-HTH<-?<-CheD<-CheC<-PilZ<-ParA-Soj-PloopNTPase<-SIG+APATPase<-SIG+TM(s)*	bacteria>firmicutes	4
<-SIGMA-HTH<-?<-SIG+TM(s)*	bacteria>proteobacteria>alphaproteobacteria	4
<-SIGMA-HTH<-CheD<-CheC<-PilZ<-?<-ParA-Soj-PloopNTPase<-SIG+APATPase<-SIG+TM(s)*	bacteria>thermotogae	4
<-SIGMA-HTH<-ParA-Soj-PloopNTPase<-SIG+APATPase<-SIG+TM(s)*	bacteria>proteobacteria>betaproteobacteria	4
<-SIGMA-HTH<-ParA-Soj-PloopNTPase<-SIG+APATPase<-SIG+TM(s)*<-TM(s)<-SIG+TM(s)<-SIG+TM<-SIG+TM(s)<-SIG+TM<-CheC<-CheC	bacteria>proteobacteria>gammaproteobacteria	4
<-SIGMA-HTH<-PilZ<-ParA-Soj-PloopNTPase<-SIG+APATPase<-SIG+TM(s)*<-TM(s)<-SIG+TM<-SIG+TM(s)<-SIG+TM<-TM	bacteria>firmicutes	4
<-TM<-REC<-SIGMA-HTH<-ParA-Soj-PloopNTPase<-SIG+APATPase<-SIG+TM(s)*<-TM(s)<-SIG+TM(s)	bacteria>proteobacteria>deltaproteobacteria	4
CheC->CheC->SIG+TM->SIG+TM(s)->SIG+TM->SIG+TM(s)->TM(s)->SIG+TM(s)*->	bacteria>actinobacteria	4
CheC->CheC->SIG+TM->SIG+TM(s)->SIG+TM->SIG+TM(s)->TM(s)->SIG+TM(s)*->SIG+APATPase->ParA-Soj-PloopNTPase->?->SIGMA-HTH->FilH->	bacteria>spirochaetes	4
CheC->CheC->SIG+TM->SIG+TM(s)->SIG+TM->SIG+TM(s)->TM(s)->SIG+TM(s)*->SIG+APATPase->ParA-Soj-PloopNTPase->SIGMA-HTH->	bacteria>firmicutes	4
CheC->CheC->SIG+TM->SIG+TM(s)->SIG+TM->SIG+TM(s)->TM(s)->SIG+TM(s)*->SIG+APATPase->ParA-Soj-PloopNTPase->SIGMA-HTH->	bacteria>proteobacteria>deltaproteobacteria	4
CheC->SIG+TM->SIG+TM(s)->SIG+TM->SIG+TM(s)->TM(s)->SIG+TM(s)*->	bacteria>other unclassified bacteria	4
Cluster120_5clades-><-?<-?<-SIGMA-HTH<-ParA-Soj-PloopNTPase<-SIG+TM(s)*	bacteria>proteobacteria>alphaproteobacteria	4
Cluster57_2clades->SIG+TM(s)*->NACHT->?->?->?->SIG+TM(s)->SIG+TM->SIG+TM(s)->	bacteria>proteobacteria>gammaproteobacteria	4
Cluster57_2clades->SIG+TM(s)*->NACHT->TET-TPase->?->Cluster103_2clades->	bacteria>proteobacteria>betaproteobacteria	4
FHA+TM->?->TPR->SIG+TM(s)*->SIG+TPR->	bacteria>proteobacteria>alphaproteobacteria	4
IONCHANNEL->SIG+TM->SIG+TM(s)*->SIG+TM(s)->	bacteria>proteobacteria>alphaproteobacteria	4
LiaI-LiaF-TM+Toast-rack*->	bacteria>fcb group	4
LiaI-LiaF-TM+Toast-rack*->SIG+TM(s)->REC->	bacteria>fcb group	4
PADR-HTH->PspC(s)+LiaI-LiaF-TM+Toast-rack(s)*->	bacteria>fcb group	4
PADR-HTH->PspC(s)+LiaI-LiaF-TM+Toast-rack*->	bacteria>fcb group	4
PspC+LiaI-LiaF-TM*->	bacteria>other unclassified bacteria	4
REC-><-SIGMA-HTH<-?<-SIG+TM(s)*<-TM(s)<-SIG+TM(s)<-SIG+TM<-SIG+TM(s)<-SIG+TM<-CheC	bacteria>other unclassified bacteria	4
REC->Cluster57_2clades->SIG+TM(s)*->NACHT->TET-TPase->?->Cluster103_2clades->SIG+TM(s)->SIG+TM->SIG+TM(s)->	bacteria>proteobacteria>betaproteobacteria	4
SIG+BetaPropeller->SIG+SAF->TM->?-><-?<-TM(s)<-SIG+TM(s)<-SIG+TM(s)*	bacteria>proteobacteria>alphaproteobacteria	4
SIG+TarH+TM+HAMP+MA->?->CheRN-Alpha+CheR-Methylase->REC->REC->SFII-RAD3->TM(s)->SIG+TM(s)*->SIG+TM->	bacteria>proteobacteria>gammaproteobacteria	4
SIG+TarH+TM+HAMP+MA->SIG+TarH+TM+HAMP+MA->CheRN-Alpha+CheR-Methylase->REC->REC->SFII-RAD3->TM(s)->SIG+TM(s)*->SIG+TM->	bacteria>proteobacteria>gammaproteobacteria	4
SIG+TM(s)->TM+OmpA->REC->SFII-RAD3->TM(s)->SIG+TM(s)*->SIG+APATPase->?->SIGMA-HTH-><-?<-Cluster40_2clades<-SIG+SAF	bacteria>proteobacteria>betaproteobacteria	4
SIG+TM(s)->TM+OmpA->TM->SIG+TM->SIG+TM(s)->SIG+TM->TM(s)->SIG+TM(s)*->SIG+APATPase->ParA-Soj-PloopNTPase->PilZ->SIGMA-HTH->	bacteria>firmicutes	4
SIG+TM(s)->TM+OmpA->TM->SIG+TM->SIG+TM(s)->SIG+TM->TM(s)->SIG+TM(s)*->SIG+APATPase->ParA-Soj-PloopNTPase->PilZ->SIGMA-HTH->?->?->SIG+BetaPropeller->	bacteria>firmicutes	4
SIG+TM(s)*->SIG+APATPase->ParA-Soj-PloopNTPase->PilZ->HPT+HISKIN+CheW->CheW->CheC->CheD->	bacteria>firmicutes	4
SIG+TM(s)*->SIG+TM->Cluster27_3clades->	bacteria>proteobacteria>betaproteobacteria	4
SIG+TM(s)*->TM(s)->	bacteria>proteobacteria>gammaproteobacteria	4
SIG+TM*->?->?->?->REC->	bacteria>firmicutes	4
TM->CheC->SIG+TM->SIG+TM(s)->SIG+TM->SIG+TM(s)->TM(s)->SIG+TM(s)*->SIG+APATPase->ParA-Soj-PloopNTPase->SIGMA-HTH->REC->SFII-RAD3->HPT+HISKIN+CheW->	bacteria>proteobacteria>gammaproteobacteria	4
TPR->SIG+TM(s)*->	bacteria>proteobacteria>betaproteobacteria	4
?*->	bacteria>fcb group	3
<-?*	bacteria>actinobacteria	3
<-?*<-PADR-HTH	bacteria>fcb group	3
<-?*<-PspC	bacteria>other unclassified bacteria	3
<-ABC-ATPase<-SIG+BetaPropeller<-SIG+BetaPropeller<-SIGMA-HTH<-SIG+TM(s)*<-TM(s)<-SIG+TM(s)<-SIG+TM<-SIG+TM(s)<-SIG+TM<-TM<-TM+OmpA	bacteria>firmicutes	3
<-Cluster133_3clades<-?<-SIG+TM<-ZetaToxin<-Cluster168_2clades||?->TM(s)->SIG+TM(s)*->Cluster39_2clades->Cluster24_2clades->SIG+TM(s)->SIG+TM->?->?->FHA->	bacteria>proteobacteria>betaproteobacteria	3
<-DUF1700-alpha-helical+PspC(s)+LiaI-LiaF-TM+Toast-rack*<-PADR-HTH	bacteria>fcb group	3
<-DUF1700-alpha-helical+PspC+LiaI-LiaF-TM*<-PADR-HTH	bacteria>other unclassified bacteria	3
<-DUF1700-alpha-helical+PspC+LiaI-LiaF-TM*<-PADR-HTH||?->?->?->Cluster297_2clades->	bacteria>other unclassified bacteria	3
<-FilH<-SIGMA-HTH<-?<-ParA-Soj-PloopNTPase<-SIG+APATPase<-SIG+TM(s)*<-TM(s)<-SIG+TM(s)<-SIG+TM<-SIG+TM(s)<-SIG+TM<-CheC<-CheC	bacteria>spirochaetes	3
<-MORC||?->TM+OmpA-><-DUF1700-alpha-helical+PspC+TM(s)+Toast-rack*<-PADR-HTH	bacteria>fcb group	3
<-NACHT<-SIG+TM(s)*	bacteria>proteobacteria>gammaproteobacteria	3
<-NACHT<-SIG+TM(s)*<-TM(s)<-SIG+TM(s)<-SIG+TM<-SIG+TM(s)<-?<-Cluster133_3clades	bacteria>proteobacteria>betaproteobacteria	3
<-ParA-Soj-PloopNTPase<-SIG+APATPase<-SIG+TM(s)*	bacteria>pvc group	3
<-ParA-Soj-PloopNTPase<-SIG+APATPase<-SIG+TM(s)*<-SIG+NtrC-AAA+FIS-HTH<-CheC<-?<-CheC<-SIG+TM	bacteria>proteobacteria>alphaproteobacteria	3
<-ParA-Soj-PloopNTPase<-SIG+APATPase<-SIG+TM(s)*<-SIG+NtrC-AAA+FIS-HTH<-SIG+TM(s)<-CheC<-?<-CheC<-SIG+TM	bacteria>proteobacteria>alphaproteobacteria	3
<-ParA-Soj-PloopNTPase<-SIG+APATPase<-SIG+TM(s)*<-TM(s)<-SIG+TM(s)<-SIG+TM<-SIG+TM(s)<-SIG+TM<-CheC	bacteria>spirochaetes	3
<-REC<-?<-?<-?<-PspC<-?<-LiaI-LiaF-TM*<-?<-TetR-HTH	bacteria>firmicutes	3
<-SIG+APATPase<-SIG+TM(s)*<-TM(s)	bacteria>proteobacteria>betaproteobacteria	3
<-SIG+TM(s)*<-?<-TM(s)	bacteria>proteobacteria>gammaproteobacteria	3
<-SIG+TM(s)*<-TM(s)<-SIG+TM(s)<-SIG+TM<-SIG+TM(s)<-CheC	bacteria>proteobacteria>gammaproteobacteria	3
<-SIG+TM(s)<-HPT+HISKIN+CheW<-SFII-RAD3<-REC<-SIGMA-HTH<-ParA-Soj-PloopNTPase<-SIG+APATPase<-SIG+TM(s)*<-TM(s)<-SIG+MHYT+TM(s)+GGDEF+EAL	bacteria>proteobacteria>gammaproteobacteria	3
<-SIG+TM(s)<-SIG+TM<-SIG+TM(s)<-Cluster24_2clades<-?<-Cluster59_2clades<-NACHT<-SIG+TM(s)*<-PYRIN<-Cluster27_3clades<-AraC-HTH	bacteria>proteobacteria>gammaproteobacteria	3
<-SIG+TM<-Cluster216_2clades<-SIG+APATPase<-SIG+TM(s)*<-TM(s)	bacteria>proteobacteria>gammaproteobacteria	3
<-SIG+TM<-SIG+TM(s)*<-TM(s)<-?<-?<-SFII-RAD3<-REC<-REC<-CheRN-Alpha+CheR-Methylase	bacteria>proteobacteria>gammaproteobacteria	3
<-SIG+TM<-SIG+TM(s)*<-TM(s)<-SFII-RAD3<-REC<-REC<-CheRN-Alpha+CheR-Methylase<-SIG+TarH+TM+HAMP+MA<-SIG+TarH+TM+HAMP+MA	bacteria>proteobacteria>gammaproteobacteria	3
<-SIG+TPR<-SIG+TM(s)*<-TPR<-?<-FHA+TM	bacteria>proteobacteria>alphaproteobacteria	3
<-SIGMA-HTH<-CheD<-CheC<-PilZ<-ParA-Soj-PloopNTPase<-SIG+APATPase<-SIG+TM(s)*<-TM(s)<-SIG+TM(s)<-ISOCOT	bacteria>thermotogae	3
<-SIGMA-HTH<-ParA-Soj-PloopNTPase<-SIG+APATPase<-SIG+TM(s)*<-TM(s)<-SFII-RAD3<-REC<-REC<-CheD<-CheRN-Alpha+CheR-Methylase	bacteria>proteobacteria>betaproteobacteria	3
<-SIGMA-HTH<-SIG+TM(s)*<-?<-?<-?<-SIG+SAF<-?<-SIG+TM(s)	bacteria>proteobacteria>alphaproteobacteria	3
<-TM(s)<-SIG+TM(s)*	bacteria>proteobacteria>gammaproteobacteria	3
<-TM(s)<-SIG+TM(s)<-SIG+TM(s)*	bacteria>proteobacteria>alphaproteobacteria	3
ABC-ATPase->?->?->?->LiaI-LiaF-TM*->	bacteria>firmicutes	3
AraC-HTH->Cluster27_3clades->PYRIN->SIG+TM(s)*->NACHT->Cluster59_2clades->?->Cluster24_2clades->SIG+TM(s)->SIG+TM->SIG+TM(s)->	bacteria>proteobacteria>betaproteobacteria	3
CheC->CheC->SIG+TM->SIG+TM(s)->SIG+TM->SIG+TM(s)->TM(s)->SIG+TM(s)*->SIG+APATPase->ParA-Soj-PloopNTPase->SIGMA-HTH->	bacteria>nitrospirae	3
CheC->CheC->SIG+TM(s)->SIG+TM->SIG+TM(s)->TM(s)->SIG+TM(s)*-><-?<-Cluster120_5clades	bacteria>proteobacteria>betaproteobacteria	3
CheC->SIG+TM->SIG+TM(s)->SIG+TM->SIG+TM(s)->TM(s)->SIG+TM(s)*->?->SIGMA-HTH->	bacteria>other unclassified bacteria	3
Cluster251_2clades->FHA+TM->Cluster172_2clades->TPR->SIG+TM(s)*->TM->Cluster154_3clades->SIG+TPR->TM(s)->	bacteria>proteobacteria>alphaproteobacteria	3
Cluster27_3clades->PYRIN->SIG+TM(s)*->NACHT->Cluster59_2clades->?->Cluster24_2clades->SIG+TM(s)->SIG+TM->SIG+TM(s)->	bacteria>proteobacteria>betaproteobacteria	3
CR-ATPase7->CR-REase10->?->TPR->SIG+TM(s)*->	bacteria>proteobacteria>betaproteobacteria	3
CR-ATPase7->SIG+TM(s)*->FHA->NACHT->TET-TPase->?->Cluster63_2clades->CheC->SIG+TM(s)->	bacteria>proteobacteria>gammaproteobacteria	3
ISOCOT-><-?<-?<-tRNA<-Cluster306_3clades<-tRNA<-tRNA<-SIGMA-HTH<-?<-?<-SIG+TM(s)*<-TM(s)<-SIG+TM(s)<-SIG+TM<-SIG+TM(s)<-SIG+TM<-CheC	bacteria>other unclassified bacteria	3
PADR-HTH->?*->	bacteria>fcb group	3
REC->Cluster57_2clades->SIG+TM(s)*->NACHT->TET-TPase->?->Cluster103_2clades->	bacteria>proteobacteria>betaproteobacteria	3
SIG+SAF->Cluster40_2clades->DICT-><-SIG+APATPase<-SIG+TM(s)*<-TM(s)	bacteria>proteobacteria>betaproteobacteria	3
SIG+TM->?->?->?->Cluster57_2clades->SIG+TM(s)*->NACHT->TET-TPase->	bacteria>proteobacteria>gammaproteobacteria	3
SIG+TM->?->CheC->SIG+TM(s)->SIG+NtrC-AAA+FIS-HTH->SIG+TM(s)*->SIG+APATPase->ParA-Soj-PloopNTPase->	bacteria>proteobacteria>alphaproteobacteria	3
SIG+TM->CheC->?->CheC->SIG+NtrC-AAA+FIS-HTH->SIG+TM(s)*->	bacteria>proteobacteria>alphaproteobacteria	3
SIG+TM(s)->?->SIG+SAF->?->?->?->SIG+TM(s)*->SIGMA-HTH->	bacteria>proteobacteria>alphaproteobacteria	3
SIG+TM(s)->SIG+TM->SIG+TM(s)->TM(s)->?->SIG+TM(s)*->SIG+APATPase->ParA-Soj-PloopNTPase->?->SIGMA-HTH->?->HD->	bacteria>other unclassified bacteria	3
SIG+TM(s)->SIG+TM->SIG+TM(s)->TM(s)->SIG+TM(s)*->?->SIG+APATPase->ParA-Soj-PloopNTPase->?->SIGMA-HTH->FilH->	bacteria>spirochaetes	3
SIG+TM(s)->TM+OmpA->TM->SIG+TM->SIG+TM(s)->SIG+TM->TM(s)->SIG+TM(s)*->SIG+APATPase->ParA-Soj-PloopNTPase->SIGMA-HTH->?->?->SIG+BetaPropeller->SIG+BetaPropeller->	bacteria>firmicutes	3
SIG+TM(s)*->SIG+APATPase->ParA-Soj-PloopNTPase->?->PilZ->CheC->CheD->SIGMA-HTH->	bacteria>thermotogae	3
SIG+TM(s)*->SIG+APATPase->ParA-Soj-PloopNTPase->?->SIGMA-HTH->FilH->	bacteria>other unclassified bacteria	3
SIG+TM(s)*->SIG+APATPase->ParA-Soj-PloopNTPase->SIGMA-HTH->	bacteria>firmicutes	3
SIG+TM(s)*->SIG+APATPase->ParA-Soj-PloopNTPase->SIGMA-HTH->REC->	bacteria>proteobacteria>gammaproteobacteria	3
SIG+TM(s)*->SIG+APATPase->ParA-Soj-PloopNTPase->SIGMA-HTH->REC->SFII-RAD3->	bacteria>proteobacteria>gammaproteobacteria	3
SIG+TM(s)*->SIG+APATPase->ParA-Soj-PloopNTPase->SIGMA-HTH->SIG+BetaPropeller->SIG+BetaPropeller->SIG+SAF->TM->	bacteria>proteobacteria>deltaproteobacteria	3
TM->SIG+TM->SIG+TM(s)->SIG+TM->TM(s)->SIG+TM(s)*->SIG+APATPase->ParA-Soj-PloopNTPase->PilZ->SIGMA-HTH->?->?->SIG+BetaPropeller->	bacteria>firmicutes	3
TM->SIG+TM->SIG+TM(s)->SIG+TM->TM(s)->SIG+TM(s)*->SIG+APATPase->ParA-Soj-PloopNTPase->SIGMA-HTH->	bacteria>firmicutes	3
TM(s)->SIG+TM(s)*->SIG+APATPase->ParA-Soj-PloopNTPase->SIGMA-HTH-><-DICT<-Cluster40_2clades	bacteria>proteobacteria>betaproteobacteria	3
TM(s)->SIG+TM(s)*->SIG+APATPase->ParA-Soj-PloopNTPase->SIGMA-HTH-><-DICT<-Cluster40_2clades<-SIG+SAF	bacteria>proteobacteria>betaproteobacteria	3
TM(s)->SIG+TM(s)*->SIG+APATPase->ParA-Soj-PloopNTPase->SIGMA-HTH->SIG+TM(s)->TM+OmpA->	bacteria>proteobacteria>betaproteobacteria	3
?*->	archaea>euryarchaeota	2
<-?*<-?*	bacteria>other unclassified bacteria	2
<-ABC-ATPase(s)||?->?-><-REC<-SIG+TM(s)<-LiaI-LiaF-TM+Toast-rack*<-?<-?||SIG+TM(s)->	bacteria>fcb group	2
<-CheD<-CheC<-CheW<-HPT+HISKIN+CheW<-REC<-ParA-Soj-PloopNTPase<-SIG+APATPase<-SIG+TM(s)*	bacteria>firmicutes	2
<-Cluster120_5clades<-?<-?<-?<-SIG+TM(s)*<-TM(s)<-SIG+TM(s)<-SIG+TM<-SIG+TM(s)	bacteria>actinobacteria	2
<-Cluster133_3clades<-?<-SIG+TM<-ZetaToxin<-Cluster168_2clades<-?||TM(s)->SIG+TM(s)*->Cluster39_2clades->Cluster24_2clades->SIG+TM(s)->SIG+TM->?->FHA->	bacteria>proteobacteria>betaproteobacteria	2
<-Cluster192_2clades<-?||?->PADR-HTH->DUF1700-alpha-helical+PspC+LiaI-LiaF-TM+Toast-rack*->	bacteria>fcb group	2
<-DUF1700-alpha-helical+PspC+LiaI-LiaF-TM+Toast-rack*<-PADR-HTH<-?||?->Cluster192_2clades->	bacteria>fcb group	2
<-HMA+TM(s)<-?||PspC->?->LiaI-LiaF-TM+Toast-rack*->	bacteria>other unclassified bacteria	2
<-IONCHANNEL<-DOUBLECORTIN<-Cluster115_5clades||SIG+SAF->Cluster40_2clades->DICT-><-SIG+APATPase<-SIG+TM(s)*<-TM(s)	bacteria>proteobacteria>betaproteobacteria	2
<-LiaI-LiaF-TM*	bacteria>firmicutes	2
<-LiaI-LiaF-TM*<-?<-?<-?<-ABC-ATPase	bacteria>firmicutes	2
<-LiaI-LiaF-TM*<-?<-?<-?<-ABC-ATPase<-?<-?<-Cluster253_2clades	bacteria>firmicutes	2
<-LiaI-LiaF-TM+Toast-rack*	archaea>euryarchaeota	2
<-LiaI-LiaF-TM+Toast-rack*	bacteria>fcb group	2
<-NACHT<-SIG+TM(s)*	bacteria>others	2
<-ParA-Soj-PloopNTPase<-SIG+APATPase<-?<-?<-?<-?<-?||SIG+TM(s)*->	bacteria>proteobacteria>epsilonproteobacteria	2
<-ParA-Soj-PloopNTPase<-SIG+APATPase<-SIG+TM(s)*<-SIG+NtrC-AAA+FIS-HTH<-CheC<-CheC<-SIG+TM<-?||?->PSYN->	bacteria>proteobacteria>alphaproteobacteria	2
<-ParA-Soj-PloopNTPase<-SIG+APATPase<-SIG+TM(s)*<-TM(s)	bacteria>proteobacteria>betaproteobacteria	2
<-ParA-Soj-PloopNTPase<-SIG+APATPase<-SIG+TM(s)*<-TM(s)<-SIG+TM(s)<-SIG+TM<-SIG+TM(s)<-SIG+TM	bacteria>firmicutes	2
<-ParA-Soj-PloopNTPase<-SIG+APATPase<-SIG+TM(s)*<-TM(s)<-SIG+TM(s)<-SIG+TM<-SIG+TM(s)<-SIG+TM	bacteria>other unclassified bacteria	2
<-REC<-?<-?<-?<-SIG+TM*	bacteria>firmicutes	2
<-REC<-SIG+CHASE3+TM+SHELIX+HISKIN||?-><-SIG+TM(s)*<-?<-SIG+NtrC-AAA+FIS-HTH<-CheC<-?<-CheC<-SIG+TM	bacteria>proteobacteria>alphaproteobacteria	2
<-REC<-SIG+TM(s)<-LiaI-LiaF-TM+Toast-rack*	bacteria>fcb group	2
<-REC<-SIGMA-HTH<-ParA-Soj-PloopNTPase<-SIG+APATPase<-SIG+TM(s)*<-TM(s)<-SIG+TM(s)<-SIG+TM<-SIG+TM(s)<-?<-CheC<-CheC	bacteria>thermodesulfobacteria	2
<-SFII-RAD3<-REC<-SIGMA-HTH<-ParA-Soj-PloopNTPase<-SIG+APATPase<-SIG+TM(s)*	bacteria>proteobacteria>gammaproteobacteria	2
<-SIG+APATPase<-SIG+TM(s)*	bacteria>nitrospirae	2
<-SIG+APATPase<-SIG+TM(s)*	bacteria>pvc group	2
<-SIG+BetaPropeller<-?<-?<-SIGMA-HTH<-PilZ<-ParA-Soj-PloopNTPase<-SIG+APATPase<-SIG+TM(s)*	bacteria>firmicutes	2
<-SIG+BetaPropeller<-SIG+APATPase<-SIG+TM(s)*<-TM(s)<-SIG+TM(s)<-SIG+TM<-SIG+TM(s)<-?<-CheC	bacteria>firmicutes	2
<-SIG+BetaPropeller<-SIGMA-HTH<-ParA-Soj-PloopNTPase<-SIG+APATPase<-SIG+TM(s)*	bacteria>proteobacteria>deltaproteobacteria	2
<-SIG+LiaI-LiaF-TM*	bacteria>actinobacteria	2
<-SIG+NtrC-AAA+FIS-HTH<-TM(s)<-SIG+TM(s)<-SIG+TM<-SIG+TM(s)*<-TPR<-?<-CR-REase10<-CR-ATPase7	bacteria>proteobacteria>deltaproteobacteria	2
<-SIG+TM(s)*	bacteria>other unclassified bacteria	2
<-SIG+TM(s)*	bacteria>proteobacteria>betaproteobacteria	2
<-SIG+TM(s)*||?->?->?->?->?->SIG+APATPase->ParA-Soj-PloopNTPase->	bacteria>proteobacteria>epsilonproteobacteria	2
<-SIG+TM(s)*||?-><-MORC	bacteria>other unclassified bacteria	2
<-SIG+TM(s)*<-?<-NACHT<-?<-TM(s)<-SIG+TM(s)<-?<-DOUBLECORTIN	bacteria>proteobacteria>epsilonproteobacteria	2
<-SIG+TM(s)*<-CheC<-?<-CheC<-SIG+TM	bacteria>proteobacteria>alphaproteobacteria	2
<-SIG+TM(s)*<-SIG+NtrC-AAA+FIS-HTH<-SIG+TM(s)	bacteria>proteobacteria>alphaproteobacteria	2
<-SIG+TM(s)*<-TM(s)<-?||?-><-Cluster294_3clades<-PSYN<-Cluster482_2clades<-SIG+IF2-HTH+sGTP	bacteria>pvc group	2
<-SIG+TM(s)*<-TM(s)<-SIG+TM(s)<-SIG+TM<-SIG+TM(s)	bacteria>others	2
<-SIG+TM(s)*<-TM(s)<-SIG+TM(s)<-SIG+TM<-SIG+TM(s)<-SIG+TM<-CheC	bacteria>spirochaetes	2
<-SIG+TM(s)*<-TM(s)<-SIG+TM(s)<-SIG+TM<-SIG+TM(s)<-SIG+TM<-CheC<-CheC	bacteria>proteobacteria>gammaproteobacteria	2
<-SIG+TM(s)<-?<-Cluster354_2clades<-?<-SIG+TM(s)*<-?<-NACHT<-?<-TM(s)<-SIG+TM(s)<-?<-DOUBLECORTIN	bacteria>proteobacteria>epsilonproteobacteria	2
<-SIG+TM(s)<-HPT+HISKIN+CheW<-SFII-RAD3<-REC<-SIGMA-HTH<-ParA-Soj-PloopNTPase<-SIG+APATPase<-SIG+TM(s)*<-TM(s)	bacteria>proteobacteria>gammaproteobacteria	2
<-SIG+TM(s)<-HPT+HISKIN+CheW<-SFII-RAD3<-REC<-SIGMA-HTH<-ParA-Soj-PloopNTPase<-SIG+APATPase<-SIG+TM(s)*<-TM(s)<-SIG+TM(s)<-SIG+TM	bacteria>proteobacteria>gammaproteobacteria	2
<-SIG+TM(s)<-SIG+TM(s)*<-SIG+TM<-IONCHANNEL	bacteria>proteobacteria>alphaproteobacteria	2
<-SIG+TM(s)<-SIG+TM<-SIG+TM(s)<-Cluster103_2clades<-?<-TET-TPase<-NACHT<-SIG+TM(s)*	bacteria>proteobacteria>betaproteobacteria	2
<-SIG+TM(s)<-SIG+TM<-SIG+TM(s)<-Cluster63_2clades<-?<-NACHT<-FHA<-SIG+TM(s)*	bacteria>proteobacteria>gammaproteobacteria	2
<-SIG+TM||TM->?->?->SIG+TM(s)->?->SIG+TM(s)*->SIG+TM(s)->TM(s)->?-><-?<-TM<-SIG+SAF<-SIG+BetaPropeller	bacteria>proteobacteria>alphaproteobacteria	2
<-SIG+TM<-SIG+TM(s)*<-TM(s)<-SFII-RAD3<-REC<-REC<-CheRN-Alpha+CheR-Methylase<-?<-SIG+TarH+TM+HAMP+MA	bacteria>proteobacteria>gammaproteobacteria	2
<-SIG+TM<-SIG+TM(s)<-?<-?<-?<-NACHT<-Cluster49_2clades<-SIG+TM(s)*<-PYRIN<-Cluster27_3clades<-AraC-HTH	bacteria>proteobacteria>gammaproteobacteria	2
<-SIG+TM<-SIG+TM(s)<-Cluster24_2clades<-?<-?<-NACHT<-Cluster49_2clades<-SIG+TM(s)*<-PYRIN<-Cluster27_3clades<-AraC-HTH	bacteria>proteobacteria>gammaproteobacteria	2
<-SIG+TM<-SIG+TM(s)<-Cluster24_2clades<-?<-Cluster59_2clades<-NACHT<-Cluster49_2clades<-SIG+TM(s)*	bacteria>proteobacteria>gammaproteobacteria	2
<-SIG+TM<-SIG+TM(s)<-Cluster24_2clades<-Cluster39_2clades<-SIG+TM(s)*<-TM(s)||Cluster168_2clades->ZetaToxin->SIG+TM->?->Cluster133_3clades->NACHT->	bacteria>proteobacteria>betaproteobacteria	2
<-SIG+TM<-SIGMA-HTH<-ParA-Soj-PloopNTPase<-SIG+APATPase<-SIG+TM(s)*<-TM(s)	bacteria>proteobacteria>betaproteobacteria	2
<-SIGMA-HTH<-?<-CheD<-CheC<-PilZ<-ParA-Soj-PloopNTPase<-SIG+APATPase<-SIG+TM(s)*<-TM(s)<-SIG+TM(s)	bacteria>firmicutes	2
<-SIGMA-HTH<-?<-SIG+TM(s)*<-TM(s)<-SIG+TM(s)<-SIG+TM<-PSE<-SIG+TM<-CheC	bacteria>other unclassified bacteria	2
<-SIGMA-HTH<-CheD<-CheC<-CheW<-REC<-ParA-Soj-PloopNTPase<-SIG+APATPase<-SIG+TM(s)*<-TM(s)<-SIG+TM(s)<-SIG+TM<-SIG+TM(s)<-SIG+TM<-REC<-CheC	bacteria>firmicutes	2
<-SIGMA-HTH<-CheD<-CheC<-REC<-?<-SIG+APATPase<-SIG+TM(s)*<-TM(s)<-SIG+TM(s)<-SIG+TM<-SIG+TM(s)<-SIG+TM<-REC<-CheC	bacteria>firmicutes	2
<-SIGMA-HTH<-ParA-Soj-PloopNTPase<-SIG+APATPase<-SIG+TM(s)*<-TM(s)<-SIG+TM(s)<-SIG+TM<-SIG+TM(s)<-SIG+TM<-CheC<-CheC	bacteria>firmicutes	2
<-SIGMA-HTH<-SIG+APATPase<-SIG+TM(s)*<-TM(s)	bacteria>proteobacteria>betaproteobacteria	2
<-SIGMA-HTH<-SIG+TM(s)*<-?<-?<-?<-SIG+SAF	bacteria>proteobacteria>alphaproteobacteria	2
<-SIGMA-HTH<-SIG+TM<-Cluster216_2clades<-SIG+APATPase<-SIG+TM(s)*<-TM(s)	bacteria>proteobacteria>gammaproteobacteria	2
<-TET-TPase<-NACHT<-SIG+TM(s)*	bacteria>proteobacteria>gammaproteobacteria	2
<-TET-TPase<-NACHT<-SIG+TM(s)*<-Cluster57_2clades	bacteria>proteobacteria>betaproteobacteria	2
<-ZetaToxin<-Cluster168_2clades||TM(s)->SIG+TM(s)*->Cluster24_2clades->SIG+TM(s)->SIG+TM->	bacteria>proteobacteria>betaproteobacteria	2
AraC-HTH->Cluster27_3clades->PYRIN->SIG+TM(s)*->	bacteria>proteobacteria>gammaproteobacteria	2
CheC->CheC->?->SIG+TM(s)->SIG+TM->SIG+TM(s)->TM(s)->SIG+TM(s)*->	bacteria>actinobacteria	2
CheC->CheC->SIG+TM->SIG+TM(s)->SIG+TM->SIG+TM(s)->TM(s)->SIG+TM(s)*->SIG+APATPase->ParA-Soj-PloopNTPase->?->FilH->?->?->Cluster108_2clades->	bacteria>spirochaetes	2
CheC->CheC->SIG+TM->SIG+TM(s)->SIG+TM->SIG+TM(s)->TM(s)->SIG+TM(s)*->SIG+APATPase->ParA-Soj-PloopNTPase->SIGMA-HTH->?->SIG+BetaPropeller->SIG+BetaPropeller->SIG+SAF->	bacteria>proteobacteria>deltaproteobacteria	2
CheC->CheC->SIG+TM->SIG+TM(s)->SIG+TM->SIG+TM(s)->TM(s)->SIG+TM(s)*->SIG+APATPase->ParA-Soj-PloopNTPase->SIGMA-HTH->SIG+TM(s)->TM+OmpA->	bacteria>proteobacteria>gammaproteobacteria	2
CheC->REC->SIG+TM->SIG+TM(s)->SIG+TM->SIG+TM(s)->TM(s)->SIG+TM(s)*->	bacteria>firmicutes	2
CheC->REC->SIG+TM->SIG+TM(s)->SIG+TM->SIG+TM(s)->TM(s)->SIG+TM(s)*->SIG+APATPase->ParA-Soj-PloopNTPase->PilZ->REC->HPT+HISKIN+CheW->CheW->	bacteria>firmicutes	2
CheC->REC->SIG+TM->SIG+TM(s)->SIG+TM->SIG+TM(s)->TM(s)->SIG+TM(s)*->SIGMA-HTH->SIG+BetaPropeller->SIG+BetaPropeller->CheC->CheD->	bacteria>firmicutes	2
CheC->SIG+TM->SIG+TM(s)->SIG+TM->SIG+TM(s)->TM(s)->SIG+TM(s)*->SIG+APATPase->ParA-Soj-PloopNTPase->?->SIGMA-HTH->FilH->	bacteria>spirochaetes	2
CheRN-Alpha+CheR-Methylase->REC->REC->SFII-RAD3->?->?->TM(s)->SIG+TM(s)*->SIG+TM->	bacteria>proteobacteria>gammaproteobacteria	2
CheRN-Alpha+CheR-Methylase->REC->REC->SFII-RAD3->TM(s)->SIG+TM(s)*->SIG+TM-><-?<-Cluster307_3clades<-Cluster420_2clades	bacteria>proteobacteria>gammaproteobacteria	2
CheRN-Alpha+CheR-Methylase->REC->REC->SFII-RAD3->TM(s)->SIG+TM(s)*->SIG+TM-><-?<-Cluster528_2clades<-?<-?<-LACI-HTH+PBPI	bacteria>proteobacteria>gammaproteobacteria	2
CheW->REC->?->SIG+TM(s)->SIG+TM->SIG+TM(s)->TM(s)->SIG+TM(s)*->SIG+APATPase->ParA-Soj-PloopNTPase->PilZ->CheC->CheD->SIGMA-HTH->	bacteria>thermotogae	2
Cluster193_7clades->PspC->LiaI-LiaF-TM+Toast-rack*->	bacteria>fcb group	2
Cluster297_2clades->?->HD+Tox-RelA+TGS->?->?->?-><-?<-SIG+TM(s)*	bacteria>proteobacteria>epsilonproteobacteria	2
Cluster40_2clades->DICT-><-TM+OmpA<-SIG+TM(s)<-SIGMA-HTH<-ParA-Soj-PloopNTPase<-SIG+APATPase<-SIG+TM(s)*<-TM(s)	bacteria>proteobacteria>betaproteobacteria	2
Cluster57_2clades->SIG+TM(s)*->NACHT->TET-TPase->?->Cluster103_2clades->SIG+TM(s)->SIG+TM->SIG+TM(s)->	bacteria>proteobacteria>betaproteobacteria	2
CR-ATPase7->SIG+TM(s)*->FHA->NACHT->TET-TPase->	bacteria>proteobacteria>gammaproteobacteria	2
FHA+TM->?->TPR->SIG+TM(s)*-><-SIG+TM(s)	bacteria>proteobacteria>alphaproteobacteria	2
LiaI-LiaF-TM(s)*->	bacteria>actinobacteria	2
LiaI-LiaF-TM*->	bacteria>other unclassified bacteria	2
LiaI-LiaF-TM+Toast-rack*->	bacteria>other unclassified bacteria	2
LiaI-LiaF-TM+Toast-rack*->?->SIG+TM(s)->REC->	bacteria>fcb group	2
LiaI-LiaF-TM+Toast-rack*-><-SIG+TIMbarrel	bacteria>firmicutes	2
LiaI-LiaF-TM+Toast-rack*->GTPase-AIG->	bacteria>other unclassified bacteria	2
MODE-HTH+PBPII-><-?<-Cluster192_2clades<-?||?->PADR-HTH->DUF1700-alpha-helical+PspC+LiaI-LiaF-TM+Toast-rack*->	bacteria>fcb group	2
PADR-HTH->DUF1700-alpha-helical+PspC(s)+LiaI-LiaF-TM+Toast-rack*->	bacteria>fcb group	2
PspC->LiaI-LiaF-TM+Toast-rack*->	bacteria>firmicutes	2
SbcC(s)+SWACOS+SbcC->?->TM(s)-><-?||PADR-HTH->DUF1700-alpha-helical+PspC+LiaI-LiaF-TM*->	bacteria>fcb group	2
SIG+BetaPropeller->?->?->?->?->IONCHANNEL->SIG+TM->SIG+TM(s)*->SIG+TM(s)->?->?->?->?-><-NACHT<-SIG+BetaPropeller	bacteria>proteobacteria>alphaproteobacteria	2
SIG+BetaPropeller->?->TM->SIG+TM->SIG+TM(s)->SIG+TM->TM(s)->SIG+TM(s)*->SIG+APATPase->ParA-Soj-PloopNTPase->PilZ->SIGMA-HTH->	bacteria>firmicutes	2
SIG+BetaPropeller->?->TM->SIG+TM->SIG+TM(s)->SIG+TM->TM(s)->SIG+TM(s)*->SIG+APATPase->ParA-Soj-PloopNTPase->PilZ->SIGMA-HTH->?->?->SIG+BetaPropeller->	bacteria>firmicutes	2
SIG+BetaPropeller->SIG+SAF->TM->?-><-?<-TM(s)<-SIG+TM(s)<-SIG+TM(s)*<-?<-?<-SIG+TM(s)<-?<-?<-TM	bacteria>proteobacteria>alphaproteobacteria	2
SIG+SAF->Cluster40_2clades->DICT-><-?<-SIG+TM<-SIG+TM(s)*<-TM(s)	bacteria>proteobacteria>gammaproteobacteria	2
SIG+TM->?->?->?->?->?->Cluster57_2clades->SIG+TM(s)*->NACHT->	bacteria>proteobacteria>gammaproteobacteria	2
SIG+TM->CheC->?->CheC->SIG+NtrC-AAA+FIS-HTH->SIG+TM(s)*-><-?<-?||?-><-ISOCOT	bacteria>proteobacteria>alphaproteobacteria	2
SIG+TM->CheC->?->CheC->SIG+NtrC-AAA+FIS-HTH->SIG+TM(s)*->SIG+APATPase->ParA-Soj-PloopNTPase->	bacteria>proteobacteria>alphaproteobacteria	2
SIG+TM->CheC->SIG+NtrC-AAA+FIS-HTH->SIG+TM(s)*->?->IONCHANNEL->	bacteria>proteobacteria>alphaproteobacteria	2
SIG+TM->SIG+TM(s)->SIG+TM->SIG+TM(s)->TM(s)->SIG+TM(s)*->	bacteria>other unclassified bacteria	2
SIG+TM->SIG+TM(s)->TM(s)->SIG+TM(s)*->	bacteria>proteobacteria>gammaproteobacteria	2
SIG+TM->SIG+TM(s)->TM(s)->SIG+TM(s)*->SIG+APATPase->ParA-Soj-PloopNTPase->SIGMA-HTH->	bacteria>nitrospirae	2
SIG+TM->SIG+TM(s)->TM(s)->SIG+TM(s)*->SIG+BetaPropeller->SIG+BetaPropeller->Cluster355_3clades->TM->Cluster112_5clades->GT->DOUBLECORTIN->	bacteria>proteobacteria>betaproteobacteria	2
SIG+TM->SIG+TM(s)->TM(s)->SIG+TM(s)*->TPR(s)-><-?<-TPR	bacteria>proteobacteria>alphaproteobacteria	2
SIG+TM->SIG+TM(s)*->SIG+TM(s)->	bacteria>proteobacteria>alphaproteobacteria	2
SIG+TM(s)->SIG+TM(s)->ABC-ATPase->?->?->TM(s)->SIG+TM(s)*->SIG+APATPase->ParA-Soj-PloopNTPase->SIGMA-HTH->	bacteria>proteobacteria>betaproteobacteria	2
SIG+TM(s)->TM(s)->SIG+TM(s)*->SIG+APATPase->?->SIGMA-HTH->	bacteria>other unclassified bacteria	2
SIG+TM(s)->TM+OmpA->TM->SIG+TM->SIG+TM(s)->SIG+TM->TM(s)->SIG+TM(s)*->SIG+APATPase->ParA-Soj-PloopNTPase->SIGMA-HTH->	bacteria>firmicutes	2
SIG+TM(s)*->	bacteria>other unclassified bacteria	2
SIG+TM(s)*->?->?->?*->?->REC->	bacteria>firmicutes	2
SIG+TM(s)*->?->?-><-?<-Cluster294_3clades<-?<-ATP-LIGASE+HhH-RADC+BRCT	bacteria>proteobacteria>epsilonproteobacteria	2
SIG+TM(s)*->?->?->FormylT->	bacteria>proteobacteria>epsilonproteobacteria	2
SIG+TM(s)*->?->?->FormylT->?->?->?->TM(s)+ABC-ATPase->	bacteria>proteobacteria>epsilonproteobacteria	2
SIG+TM(s)*->?->SIGMA-HTH->SIG+TM(s)->	bacteria>other unclassified bacteria	2
SIG+TM(s)*->Cluster49_2clades->NACHT->?->?->?->SIG+TM(s)->SIG+TM->	bacteria>proteobacteria>gammaproteobacteria	2
SIG+TM(s)*->SIG+APATPase->	bacteria>proteobacteria>gammaproteobacteria	2
SIG+TM(s)*->SIG+APATPase->ParA-Soj-PloopNTPase->	bacteria>pvc group	2
SIG+TM(s)*->SIG+APATPase->ParA-Soj-PloopNTPase->PilZ->REC->HPT+HISKIN+CheW->CheW->CheC->	bacteria>firmicutes	2
SIG+TM(s)*->SIG+APATPase->ParA-Soj-PloopNTPase->REC->HPT+HISKIN+CheW->CheW->CheC->CheD->	bacteria>firmicutes	2
SIG+TM(s)*->SIG+TarH+TM+HAMP+MA->	bacteria>proteobacteria>alphaproteobacteria	2
SIG+TM(s)*->SIG+TM(s)->TM(s)->?->HIN-HTH->PSE->?->CHTH->	bacteria>proteobacteria>alphaproteobacteria	2
SIG+TM(s)*->SIG+TPR->	bacteria>proteobacteria>alphaproteobacteria	2
SIG+TM*->	bacteria>firmicutes	2
SIG+TM*->?->?->?->REC-><-Cluster515_2clades	bacteria>firmicutes	2
SIGMA-HTH->FilH->?-><-ParA-Soj-PloopNTPase<-SIG+APATPase<-SIG+TM(s)*<-TM(s)<-SIG+TM(s)<-SIG+TM<-SIG+TM(s)<-SIG+TM<-CheC<-CheC	bacteria>spirochaetes	2
TM->CheC->PSE->SIG+TM->SIG+TM(s)->SIG+TM->SIG+TM(s)->TM(s)->SIG+TM(s)*->SIG+APATPase->ParA-Soj-PloopNTPase->SIGMA-HTH->?->SIG+BetaPropeller->SIG+BetaPropeller->SIG+SAF->	bacteria>proteobacteria>deltaproteobacteria	2
TM->SIG+TM->SIG+TM(s)->SIG+TM->SIG+TM(s)->TM(s)->SIG+TM(s)*->SIGMA-HTH->SIG+BetaPropeller->SIG+BetaPropeller->ABC-ATPase->	bacteria>firmicutes	2
TM(s)->SIG+TM(s)*->Cluster255_4clades->SIG+TM->	bacteria>proteobacteria>gammaproteobacteria	2
TM(s)->SIG+TM(s)*->SIG+APATPase->?->SIGMA-HTH-><-?<-Cluster40_2clades<-SIG+SAF	bacteria>proteobacteria>betaproteobacteria	2
TM(s)->SIG+TM(s)*->SIG+APATPase-><-DICT<-Cluster40_2clades<-SIG+SAF||Cluster115_5clades->DOUBLECORTIN->IONCHANNEL->	bacteria>proteobacteria>betaproteobacteria	2
TM(s)->SIG+TM(s)*->SIG+APATPase->ParA-Soj-PloopNTPase->SIGMA-HTH->SIG+TM-><-DICT<-Cluster40_2clades	bacteria>proteobacteria>betaproteobacteria	2
TM(s)->SIG+TM(s)*->SIG+APATPase->ParA-Soj-PloopNTPase->SIGMA-HTH->SIG+TM-><-DICT<-Cluster40_2clades<-SIG+SAF	bacteria>proteobacteria>betaproteobacteria	2
TM(s)->SIG+TM(s)*->SIG+APATPase->ParA-Soj-PloopNTPase->SIGMA-HTH->SIG+TM(s)->	bacteria>proteobacteria>betaproteobacteria	2
TPR->SIG+TM(s)*->SIG+TM->SIG+TM(s)->TM(s)->	bacteria>proteobacteria>deltaproteobacteria	2
TRAM+METHYLASE->tRNA->PSYN->?->TM(s)->SIG+TM(s)*->SIG+APATPase->ParA-Soj-PloopNTPase->SIGMA-HTH->SIG+TM(s)-><-SIG+TarH+TM+HAMP+MA	bacteria>proteobacteria>betaproteobacteria	2
?*->	bacteria>proteobacteria>deltaproteobacteria	1
?*->	eukaryota>metazoa	1
?*->?-><-PIN+APATPase	bacteria>other unclassified bacteria	1
?*->?-><-SIG+PEP-utilisers-C	bacteria>actinobacteria	1
?*->?->LiaI-LiaF-TM+Toast-rack*->?->REC->	bacteria>firmicutes	1
?*->?->SIG+PSYN->	bacteria>other unclassified bacteria	1
?*->?*->	bacteria>other unclassified bacteria	1
?*-><-?<-Cluster193_7clades	bacteria>firmicutes	1
?*-><-?<-ParA-Soj-PloopNTPase	bacteria>proteobacteria>gammaproteobacteria	1
?*-><-TM(s)	bacteria>firmicutes	1
<-?*	bacteria>cyanobacteria	1
<-?*	eukaryota>metazoa	1
<-?*<-?||?->?->ABC-ATPase->	bacteria>firmicutes	1
<-?*<-?<-?*	bacteria>other unclassified bacteria	1
<-?*<-?<-?<-?<-SIGMA-HTH	bacteria>acidobacteria	1
<-?*<-?<-?<-SIGMA-HTH	bacteria>firmicutes	1
<-?*<-?<-?<-SIGMA-HTH<-?<-Cluster856_2clades	bacteria>firmicutes	1
<-ABC-ATPase(s)||?->?-><-REC<-SIG+TM(s)<-LiaI-LiaF-TM+Toast-rack*	bacteria>fcb group	1
<-ABC-ATPase(s)||?->?->LiaI-LiaF-TM+Toast-rack*-><-LACI-HTH+PBPI	bacteria>firmicutes	1
<-ABC-ATPase<-?||Cluster193_7clades->?*->LiaI-LiaF-TM+Toast-rack*->	bacteria>fcb group	1
<-ABC-ATPase<-?<-?<-?<-SIG+TM(s)*<-TM(s)<-SIG+TM(s)<-SIG+TM<-SIG+TM(s)<-CheC<-CheC	bacteria>proteobacteria>gammaproteobacteria	1
<-ABC-ATPase<-DOC+BirA-HTH<-?*	bacteria>other unclassified bacteria	1
<-ABC-ATPase<-REC<-?<-REC<-?<-LiaI-LiaF-TM+Toast-rack*	bacteria>firmicutes	1
<-ABC-ATPase<-SIG+BetaPropeller<-?<-SIGMA-HTH<-SIG+TM(s)*<-TM(s)<-SIG+TM(s)<-SIG+TM<-SIG+TM(s)<-SIG+TM<-TM<-TM+OmpA	bacteria>firmicutes	1
<-ABC-ATPase<-SIG+BetaPropeller<-SIG+BetaPropeller<-SIGMA-HTH<-SIG+TM(s)*<-TM(s)<-SIG+TM(s)<-SIG+TM<-SIG+TM(s)<-SIG+TM<-TM	bacteria>firmicutes	1
<-CheC<-?||SIG+Lysozyme-><-SIG+BetaPropeller<-SIG+BetaPropeller<-ParA-Soj-PloopNTPase<-SIG+APATPase<-SIG+TM(s)*<-TM(s)<-SIG+TM(s)<-SIG+TM<-SIG+TM(s)<-SIG+TM	bacteria>firmicutes	1
<-CheC<-?||SIG+Lysozyme-><-SIG+BetaPropeller<-SIG+BetaPropeller<-ParA-Soj-PloopNTPase<-SIG+APATPase<-SIG+TM(s)*<-TM(s)<-SIG+TM(s)<-SIG+TM<-SIG+TM(s)<-SIG+TM||Cluster440_3clades->	bacteria>firmicutes	1
<-CheC<-?<-?<-TET-TPase<-NACHT<-FHA<-?<-SIG+TM(s)*<-CR-ATPase7<-?<-REC	bacteria>proteobacteria>gammaproteobacteria	1
<-CheC<-CheC<-REC<-SIGMA-HTH<-?<-ParA-Soj-PloopNTPase<-SIG+APATPase<-SIG+TM(s)*<-TM(s)<-SIG+TM(s)<-SIG+TM<-SIG+TM(s)<-?<-CheC<-TM	bacteria>chrysiogenetes	1
<-CheC<-CheC<-SIGMA-HTH<-SIG+TM(s)*<-TM(s)<-SIG+TM(s)<-SIG+TM<-SIG+TM(s)<-?<-CheC	bacteria>acidobacteria	1
<-CheC<-CheC<-SIGMA-HTH<-SIG+TM(s)*<-TM(s)<-SIG+TM(s)<-SIG+TM<-SIG+TM(s)<-?<-CheC<-SIG+BetaPropeller	bacteria>acidobacteria	1
<-CheC<-CheW<-HPT+HISKIN+CheW<-REC<-PilZ<-ParA-Soj-PloopNTPase<-SIG+APATPase<-SIG+TM(s)*<-TM(s)	bacteria>firmicutes	1
<-CheC<-CheW<-HPT+HISKIN+CheW<-REC<-PilZ<-ParA-Soj-PloopNTPase<-SIG+APATPase<-SIG+TM(s)*<-TM(s)<-SIG+TM(s)<-SIG+TM<-?<-CheC<-TM	bacteria>firmicutes	1
<-CheC<-CheW<-HPT+HISKIN+CheW<-REC<-PilZ<-ParA-Soj-PloopNTPase<-SIG+APATPase<-SIG+TM(s)*<-TM(s)<-SIG+TM(s)<-SIG+TM<-SIG+TM(s)<-?<-REC<-CheC	bacteria>firmicutes	1
<-CheC<-CheW<-HPT+HISKIN+CheW<-REC<-PilZ<-ParA-Soj-PloopNTPase<-SIG+APATPase<-SIG+TM(s)*<-TM(s)<-SIG+TM(s)<-SIG+TM<-SIG+TM(s)<-SIG+TM<-CheC<-CheC	bacteria>firmicutes	1
<-CheC<-CheW<-HPT+HISKIN+CheW<-REC<-PilZ<-ParA-Soj-PloopNTPase<-SIG+APATPase<-SIG+TM(s)*<-TM(s)<-SIG+TM(s)<-SIG+TM<-SIG+TM(s)<-SIG+TM<-REC	bacteria>firmicutes	1
<-CheD<-CheC<-CheW<-HPT+HISKIN+CheW<-PilZ<-ParA-Soj-PloopNTPase<-SIG+APATPase<-SIG+TM(s)*	bacteria>firmicutes	1
<-CheD<-CheC<-CheW<-HPT+HISKIN+CheW<-REC<-ParA-Soj-PloopNTPase<-SIG+APATPase<-SIG+TM(s)*<-TM(s)<-SIG+TM(s)<-SIG+TM<-SIG+TM(s)<-SIG+TM	bacteria>firmicutes	1
<-CheD<-CheC<-CheW<-HPT+HISKIN+CheW<-REC<-ParA-Soj-PloopNTPase<-SIG+APATPase<-SIG+TM(s)*<-TM(s)<-SIG+TM(s)<-SIG+TM<-SIG+TM(s)<-SIG+TM<-REC<-PSE<-CheC	bacteria>firmicutes	1
<-CheD<-CheC<-FilH<-SIG+BetaPropeller<-SIG+BetaPropeller<-SIGMA-HTH<-SIG+TM(s)*<-TM(s)<-SIG+TM(s)<-SIG+TM<-SIG+TM(s)<-SIG+TM<-REC<-CheC	bacteria>firmicutes	1
<-CheD<-CheC<-HPT+HISKIN+CheW<-REC<-PilZ<-ParA-Soj-PloopNTPase<-SIG+APATPase<-SIG+TM(s)*<-TM(s)<-SIG+TM(s)<-SIG+TM<-SIG+TM(s)<-?<-REC<-CheC	bacteria>synergistetes	1
<-CheD<-CheC<-SIG+BetaPropeller<-SIG+BetaPropeller<-SIGMA-HTH<-SIG+TM(s)*<-TM(s)<-SIG+TM(s)<-SIG+TM<-SIG+TM(s)<-?<-REC<-CheC	bacteria>firmicutes	1
<-CheD<-CheC<-SIG+BetaPropeller<-SIG+BetaPropeller<-SIGMA-HTH<-SIG+TM(s)*<-TM(s)<-SIG+TM(s)<-SIG+TM<-SIG+TM(s)<-SIG+TM<-CheC<-DOUBLECORTIN	bacteria>firmicutes	1
<-CheD<-CheC<-SIG+BetaPropeller<-SIG+BetaPropeller<-SIGMA-HTH<-SIG+TM(s)*<-TM(s)<-SIG+TM(s)<-SIG+TM<-SIG+TM(s)<-SIG+TM<-REC<-CheC	bacteria>firmicutes	1
<-CheD<-SIG+BetaPropeller<-?<-SIGMA-HTH<-PilZ<-ParA-Soj-PloopNTPase<-SIG+APATPase<-SIG+TM(s)*<-TM(s)<-SIG+TM(s)<-SIG+TM	bacteria>firmicutes	1
<-CheD<-SIG+BetaPropeller<-?<-SIGMA-HTH<-PilZ<-ParA-Soj-PloopNTPase<-SIG+APATPase<-SIG+TM(s)*<-TM(s)<-SIG+TM(s)<-SIG+TM<-SIG+TM(s)<-SIG+TM<-CheC<-TM	bacteria>firmicutes	1
<-CheD<-SIG+BetaPropeller<-SIG+BetaPropeller<-SIGMA-HTH<-PilZ<-ParA-Soj-PloopNTPase<-SIG+APATPase<-SIG+TM(s)*	bacteria>firmicutes	1
<-CheW<-HPT+HISKIN+CheW<-ParA-Soj-PloopNTPase<-SIG+APATPase<-SIG+TM(s)*<-TM(s)<-SIG+TM(s)<-SIG+TM<-SIG+TM(s)<-SIG+TM<-REC<-CheC	bacteria>firmicutes	1
<-CheW<-HPT+HISKIN+CheW<-REC<-ParA-Soj-PloopNTPase<-SIG+APATPase<-SIG+TM(s)*<-TM(s)<-SIG+TM(s)<-SIG+TM<-SIG+TM(s)<-SIG+TM<-REC<-CheC	bacteria>firmicutes	1
<-CheW<-HPT+HISKIN+CheW<-SFII-RAD3<-REC<-SIGMA-HTH<-ParA-Soj-PloopNTPase<-SIG+APATPase<-SIG+TM(s)*<-MULE-TRANSPOSASE<-TM(s)<-SIG+TM(s)<-SIG+TM<-SIG+TM(s)<-SIG+TM<-CheC	bacteria>proteobacteria>gammaproteobacteria	1
<-Cluster103_2clades<-?<-TET-TPase<-NACHT<-SIG+TM(s)*<-Cluster57_2clades<-REC	bacteria>proteobacteria>betaproteobacteria	1
<-Cluster103_2clades<-Cluster179_2clades<-TET-TPase<-NACHT<-SIG+TM(s)*	bacteria>proteobacteria>gammaproteobacteria	1
<-Cluster103_2clades<-Cluster179_2clades<-TET-TPase<-NACHT<-SIG+TM(s)*<-Cluster57_2clades	bacteria>proteobacteria>betaproteobacteria	1
<-Cluster103_2clades<-PSE<-TET-TPase<-NACHT<-SIG+TM(s)*<-Cluster57_2clades	bacteria>proteobacteria>gammaproteobacteria	1
<-Cluster108_2clades<-?<-?<-FilH<-?<-ParA-Soj-PloopNTPase<-SIG+APATPase<-SIG+TM(s)*<-TM(s)<-SIG+TM(s)<-SIG+TM<-SIG+TM(s)<-SIG+TM<-SIG+TM	bacteria>spirochaetes	1
<-Cluster115_5clades||SIG+SAF->Cluster40_2clades->?-><-SIGMA-HTH<-?<-SIG+APATPase<-SIG+TM(s)*<-TM(s)	bacteria>proteobacteria>betaproteobacteria	1
<-Cluster115_5clades<-?||CheC->?->SIG+TM->CheC->?->SIG+TM(s)*->?->IONCHANNEL->	bacteria>proteobacteria>alphaproteobacteria	1
<-Cluster115_5clades<-?||CheC->?->SIG+TM->CheC->SIG+NtrC-AAA+FIS-HTH->SIG+TM(s)*->?->IONCHANNEL->	bacteria>proteobacteria>alphaproteobacteria	1
<-Cluster133_3clades<-?<-SIG+TM<-?<-Cluster623_2clades<-?<-Cluster27_3clades<-SIG+TM(s)*<-SIG+Lysozyme	bacteria>proteobacteria>alphaproteobacteria	1
<-Cluster133_3clades<-Cluster822_2clades<-SIG+TM<-ZetaToxin<-Cluster168_2clades<-?||TM(s)->SIG+TM(s)*->	bacteria>proteobacteria>betaproteobacteria	1
<-Cluster192_2clades<-?||?->?->PADR-HTH->DUF1700-alpha-helical+PspC+LiaI-LiaF-TM+Toast-rack*->	bacteria>fcb group	1
<-Cluster192_2clades<-?<-?||?->?->PADR-HTH->DUF1700-alpha-helical+PspC+LiaI-LiaF-TM+Toast-rack*->	bacteria>fcb group	1
<-Cluster193_7clades<-?<-?<-?<-?<-SIG+TM(s)*<-TM(s)	bacteria>pvc group	1
<-Cluster216_2clades<-SIG+APATPase<-SIG+TM(s)*<-TM(s)<-TM+OmpA<-SIG+TM(s)	bacteria>proteobacteria>gammaproteobacteria	1
<-Cluster255_4clades<-SIG+TM(s)*<-TM(s)	bacteria>pvc group	1
<-Cluster297_2clades<-?<-?<-?||PADR-HTH->DUF1700-alpha-helical+PspC+LiaI-LiaF-TM*->	bacteria>other unclassified bacteria	1
<-Cluster301_2clades||SIG+TPR->?-><-Cluster154_3clades<-TM<-SIG+TM(s)*<-TPR<-Cluster172_2clades<-FHA+TM<-Cluster251_2clades	bacteria>proteobacteria>gammaproteobacteria	1
<-Cluster354_2clades<-?<-?<-?<-?<-?<-?<-SIG+TM(s)*<-?<-NACHT<-?<-TM(s)<-SIG+TM(s)<-?<-DOUBLECORTIN	bacteria>proteobacteria>epsilonproteobacteria	1
<-Cluster426_2clades<-?<-?<-?<-?<-SIG+TM(s)*	bacteria>proteobacteria>epsilonproteobacteria	1
<-Cluster515_2clades<-?<-?<-Cluster193_7clades<-?<-REC<-SIG+TM(s)<-LiaI-LiaF-TM+Toast-rack*	bacteria>fcb group	1
<-Cluster542_3clades<-SIG+TM(s)*<-SIG+NtrC-AAA+FIS-HTH<-CheC<-?<-CheC<-SIG+TM	bacteria>proteobacteria>alphaproteobacteria	1
<-Cluster562_2clades||?-><-?<-?||?-><-SIG+TM<-SIG+TM(s)*<-TM(s)	bacteria>proteobacteria>gammaproteobacteria	1
<-Cluster638_2clades<-?<-?<-REC<-SIG+TM(s)<-LiaI-LiaF-TM+Toast-rack*	bacteria>fcb group	1
<-Cluster709_2clades<-Cluster588_2clades||?->PADR-HTH->?*->	bacteria>fcb group	1
<-Cluster759_2clades||PSE-><-PSE<-SIG+TM(s)*	bacteria>proteobacteria>alphaproteobacteria	1
<-Cluster765_2clades<-?<-?<-?<-?<-?<-SIG+TM(s)*||?->?-><-?<-?<-Cluster112_5clades<-?<-SIG+PSYN	bacteria>proteobacteria>epsilonproteobacteria	1
<-Cluster765_2clades<-?<-REC<-?<-?<-REC<-?<-LiaI-LiaF-TM+Toast-rack*	bacteria>firmicutes	1
<-Cluster773_2clades<-?||?-><-?<-?<-?<-DUF1700-alpha-helical+PspC+LiaI-LiaF-TM+Toast-rack*<-PADR-HTH	bacteria>fcb group	1
<-Cluster774_2clades<-SIGMA-HTH<-?<-?<-SIG+TM(s)*	bacteria>other unclassified bacteria	1
<-DOUBLECORTIN<-Cluster115_5clades||?->?-><-SIGMA-HTH<-ParA-Soj-PloopNTPase<-?<-SIG+TM(s)*	bacteria>proteobacteria>alphaproteobacteria	1
<-DOUBLECORTIN<-Cluster115_5clades<-SIG+TPR<-?<-SIGMA-HTH<-ParA-Soj-PloopNTPase<-SIG+APATPase<-SIG+TM(s)*<-Cluster309_2clades<-Cluster112_5clades<-TM	bacteria>aquificae	1
<-DOUBLECORTIN<-Cluster115_5clades<-SIG+TPR<-?<-SIGMA-HTH<-ParA-Soj-PloopNTPase<-SIG+APATPase<-SIG+TM(s)*<-Cluster309_2clades<-Cluster112_5clades<-TM<-SIG+SAF<-SIG+BetaPropeller<-SIG+BetaPropeller	bacteria>aquificae	1
<-DOUBLECORTIN<-GT<-Cluster112_5clades<-TM<-?<-SIG+BetaPropeller<-SIG+BetaPropeller<-SIG+TM(s)*<-TM(s)<-SIG+TM(s)<-SIG+TM	bacteria>proteobacteria>betaproteobacteria	1
<-DOUBLECORTIN<-GT<-Cluster112_5clades<-TM<-?<-SIG+BetaPropeller<-SIG+BetaPropeller<-SIG+TM(s)*<-TM(s)<-SIG+TM(s)<-SIG+TM<-TPR(s)<-?<-?<-TPR	bacteria>proteobacteria>gammaproteobacteria	1
<-DOUBLECORTIN<-GT<-Cluster112_5clades<-TM<-Cluster355_3clades<-SIG+BetaPropeller<-SIG+BetaPropeller<-SIG+TM(s)*<-TM(s)<-SIG+TM(s)<-SIG+TM	bacteria>proteobacteria>betaproteobacteria	1
<-DOUBLECORTIN<-GT<-Cluster112_5clades<-TM<-Cluster541_2clades<-SIG+BetaPropeller<-SIG+BetaPropeller<-SIG+TM(s)*<-TM(s)<-SIG+TM(s)<-SIG+TM	bacteria>proteobacteria>betaproteobacteria	1
<-DOUBLECORTIN<-GT<-Cluster112_5clades<-TM<-Cluster541_2clades<-SIG+BetaPropeller<-SIG+BetaPropeller<-SIG+TM(s)*<-TM(s)<-SIG+TM(s)<-SIG+TM<-TPR(s)	bacteria>proteobacteria>gammaproteobacteria	1
<-DOUBLECORTIN<-GT<-Cluster112_5clades<-TM<-SIG+SAF<-SIG+BetaPropeller<-SIG+BetaPropeller<-SIG+TM(s)*<-TM(s)<-SIG+TM(s)<-SIG+TM	bacteria>proteobacteria>gammaproteobacteria	1
<-DOUBLECORTIN<-GT<-Cluster112_5clades<-TM<-SIG+SAF<-SIG+BetaPropeller<-SIG+BetaPropeller<-SIG+TM(s)*<-TM(s)<-SIG+TM(s)<-SIG+TM<-TPR(s)	bacteria>proteobacteria>gammaproteobacteria	1
<-DUF1700-alpha-helical+PspC+LiaI-LiaF-TM*<-PADR-HTH||?->?->?->?->?-><-Cluster776_2clades	bacteria>fcb group	1
<-DUF1700-alpha-helical+PspC+LiaI-LiaF-TM+Toast-rack*<-PADR-HTH||?->?-><-MODE-HTH+PBPII	bacteria>fcb group	1
<-ENOYCOADEHYD<-?<-?<-SIGMA-HTH<-?<-?<-SIG+APATPase<-SIG+TM(s)*	bacteria>pvc group	1
<-FHA<-?<-?<-SIG+TM<-SIG+TM(s)<-Cluster24_2clades<-Cluster39_2clades<-SIG+TM(s)*<-TM(s)||Cluster168_2clades->ZetaToxin->SIG+TM->?->Cluster133_3clades->NACHT->	bacteria>proteobacteria>betaproteobacteria	1
<-FHA<-?<-SIG+TM<-SIG+TM(s)<-Cluster24_2clades<-Cluster39_2clades<-SIG+TM(s)*<-TM(s)||Cluster168_2clades->ZetaToxin->SIG+TM->Cluster822_2clades->Cluster133_3clades->NACHT->	bacteria>proteobacteria>gammaproteobacteria	1
<-FilH<-?<-?<-ParA-Soj-PloopNTPase<-SIG+APATPase<-SIG+TM(s)*<-TM(s)<-SIG+TM(s)<-?<-SIG+TM<-SIG+TM(s)<-SIG+TM<-CheC	bacteria>spirochaetes	1
<-FilH<-?<-ParA-Soj-PloopNTPase<-SIG+APATPase<-SIG+TM(s)*<-TM(s)<-SIG+TM(s)<-SIG+TM<-SIG+TM(s)<-SIG+TM<-CheC<-CheC	bacteria>spirochaetes	1
<-FilH<-SIGMA-HTH<-?<-?<-?<-ParA-Soj-PloopNTPase<-SIG+APATPase<-SIG+TM(s)*<-TM(s)<-SIG+TM(s)<-SIG+TM<-SIG+TM(s)	bacteria>fcb group	1
<-FilH<-SIGMA-HTH<-?<-ParA-Soj-PloopNTPase<-SIG+APATPase<-?<-SIG+TM(s)*<-TM(s)<-SIG+TM(s)<-SIG+TM<-SIG+TM(s)	bacteria>spirochaetes	1
<-FilH<-SIGMA-HTH<-?<-ParA-Soj-PloopNTPase<-SIG+APATPase<-SIG+TM(s)*	bacteria>spirochaetes	1
<-FilH<-SIGMA-HTH<-?<-ParA-Soj-PloopNTPase<-SIG+APATPase<-SIG+TM(s)*<-TM(s)<-SIG+TM(s)<-SIG+TM<-SIG+TM(s)<-SIG+TM	bacteria>spirochaetes	1
<-FilH<-SIGMA-HTH<-?<-ParA-Soj-PloopNTPase<-SIG+APATPase<-SIG+TM(s)*<-TM(s)<-SIG+TM(s)<-SIG+TM<-SIG+TM(s)<-SIG+TM<-CheC	bacteria>spirochaetes	1
<-FilH<-SIGMA-HTH<-?<-PilZ<-ParA-Soj-PloopNTPase<-SIG+APATPase<-SIG+TM(s)*<-TM(s)<-SIG+TM(s)<-SIG+TM<-SIG+TM(s)<-?<-CheC<-CheC	bacteria>firmicutes	1
<-FilH<-SIGMA-HTH<-CheD<-CheC<-REC<-ParA-Soj-PloopNTPase<-SIG+APATPase<-SIG+TM(s)*<-TM(s)<-SIG+TM(s)<-SIG+TM<-SIG+TM(s)<-SIG+TM<-REC<-CheC	bacteria>firmicutes	1
<-FURR-HTH<-LiaI-LiaF-TM+Toast-rack*<-?<-?<-SIGMA-HTH	bacteria>firmicutes	1
<-GT<-Cluster112_5clades<-TM<-Cluster355_3clades<-SIG+BetaPropeller<-SIG+BetaPropeller||?-><-SIG+TM(s)*<-TM(s)<-SIG+TM(s)<-SIG+TM	bacteria>proteobacteria>alphaproteobacteria	1
<-GTPase-AIG<-LiaI-LiaF-TM+Toast-rack*	bacteria>other unclassified bacteria	1
<-HD<-?<-SIGMA-HTH<-?<-ParA-Soj-PloopNTPase<-SIG+APATPase<-SIG+TM(s)*<-?<-TM(s)<-SIG+TM(s)<-SIG+TM<-SIG+TM(s)	bacteria>other unclassified bacteria	1
<-HISKIN<-HD<-HD<-SIGMA-HTH<-?<-ParA-Soj-PloopNTPase<-SIG+APATPase<-SIG+TM(s)*<-TM(s)<-SIG+TM(s)<-SIG+TM<-SIG+TM(s)<-Cluster617_2clades<-CheC<-CheC	bacteria>fcb group	1
<-HISKIN<-HD<-HD<-SIGMA-HTH<-?<-ParA-Soj-PloopNTPase<-SIG+APATPase<-SIG+TM(s)*<-TM(s)<-SIG+TM(s)<-SIG+TM<-SIG+TM(s)<-Cluster617_2clades<-CheC<-CheC	bacteria>other unclassified bacteria	1
<-HPT+HISKIN+CheW<-REC<-ParA-Soj-PloopNTPase<-SIG+APATPase<-SIG+TM(s)*<-TM(s)<-SIG+TM(s)<-SIG+TM<-SIG+TM(s)<-SIG+TM<-REC<-CheC	bacteria>firmicutes	1
<-HPT+HISKIN+CheW<-SFII-RAD3<-REC<-SIGMA-HTH<-ParA-Soj-PloopNTPase<-SIG+APATPase<-SIG+TM(s)*<-TM(s)	bacteria>proteobacteria>gammaproteobacteria	1
<-HPT+HISKIN+CheW<-SFII-RAD3<-REC<-SIGMA-HTH<-ParA-Soj-PloopNTPase<-SIG+APATPase<-SIG+TM(s)*<-TM(s)<-SIG+TM(s)<-SIG+TM<-SIG+TM(s)<-SIG+TM<-CheC<-CheC	bacteria>proteobacteria>gammaproteobacteria	1
<-HPT+HISKIN+CheW<-SFII-RAD3<-REC<-SIGMA-HTH<-ParA-Soj-PloopNTPase<-SIG+APATPase<-SIG+TM(s)*<-TM(s)<-SIG+TM(s)<-SIG+TM<-SIG+TM(s)<-SIG+TM<-CheC<-TM	bacteria>proteobacteria>gammaproteobacteria	1
<-HPT+HISKIN+CheW<-SIG+TarH+TM+HAMP+MA<-?<-?<-?<-?<-SIG+TM(s)<-SIG+TM(s)*<-SIG+TM<-IONCHANNEL<-?<-?<-?<-?<-SIG+BetaPropeller	bacteria>proteobacteria>alphaproteobacteria	1
<-IONCHANNEL<-?||?-><-SIG+TM(s)*<-SIG+NtrC-AAA+FIS-HTH	bacteria>proteobacteria>alphaproteobacteria	1
<-IONCHANNEL<-DOUBLECORTIN<-Cluster115_5clades||SIG+SAF->Cluster40_2clades->DICT-><-SIG+TM<-SIG+TM(s)*<-TM(s)<-?<-SFII-RAD3<-REC<-REC<-CheRN-Alpha+CheR-Methylase	bacteria>proteobacteria>gammaproteobacteria	1
<-ISOCOT+SIR2||?->?->?-><-?||?-><-?*	bacteria>actinobacteria	1
<-LACI-HTH+PBPI||?-><-?<-?<-?<-?||LiaI-LiaF-TM+Toast-rack*->?->REC->	bacteria>firmicutes	1
<-LiaI-LiaF-TM(s)*	bacteria>actinobacteria	1
<-LiaI-LiaF-TM*	bacteria>other unclassified bacteria	1
<-LiaI-LiaF-TM*<-?<-?<-Cluster814_2clades	bacteria>other unclassified bacteria	1
<-LiaI-LiaF-TM+Toast-rack*	bacteria>proteobacteria>betaproteobacteria	1
<-LiaI-LiaF-TM+Toast-rack*<-?<-?<-?||TM(s)+ABC-ATPase->	bacteria>other unclassified bacteria	1
<-LiaI-LiaF-TM+Toast-rack*<-?<-?<-SIGMA-HTH	bacteria>firmicutes	1
<-LiaI-LiaF-TM+Toast-rack*<-?<-PspC	bacteria>other unclassified bacteria	1
<-LiaI-LiaF-TM+Toast-rack*<-?<-PspC||?->HMA+TM(s)->	bacteria>other unclassified bacteria	1
<-LiaI-LiaF-TM+Toast-rack*<-Cluster854_2clades	bacteria>other unclassified bacteria	1
<-LiaI-LiaF-TM+Toast-rack*<-PspC	bacteria>fcb group	1
<-LiaI-LiaF-TM+Toast-rack*<-PspC	bacteria>other unclassified bacteria	1
<-LiaI-LiaF-TM+Toast-rack*<-PspC+LiaI-LiaF-TM*<-Cluster193_7clades	bacteria>fcb group	1
<-LiaI-LiaF-TM+Toast-rack*<-SIG+TM(s)<-ABC-ATPase	bacteria>other unclassified bacteria	1
<-LiaI-LiaF-TM+Toast-rack+EP1*<-TM+LiaI-LiaF-TM*<-?<-SIGMA-HTH	bacteria>acidobacteria	1
<-MODE-HTH+PBPII||?->?->?->LiaI-LiaF-TM+Toast-rack*->?->REC-><-Cluster562_2clades	bacteria>firmicutes	1
<-MULE-TRANSPOSASE||REC->SIG+TM->SIG+TM(s)->SIG+TM->SIG+TM(s)->TM(s)->SIG+TM(s)*->SIG+APATPase->ParA-Soj-PloopNTPase->REC->PSE->CheW->CheC->CheD->	bacteria>firmicutes	1
<-NACHT||Cluster115_5clades->DOUBLECORTIN->?->SIG+TM->?->SIG+TM(s)*->SIG+TM(s)->TM(s)->	bacteria>proteobacteria>alphaproteobacteria	1
<-NACHT||Cluster115_5clades->DOUBLECORTIN->?->SIG+TM->?->SIG+TM(s)*->SIG+TM(s)->TM(s)->?-><-?<-?<-?<-Cluster112_5clades	bacteria>proteobacteria>alphaproteobacteria	1
<-NACHT||Cluster115_5clades->DOUBLECORTIN->?->SIG+TM->?->SIG+TM(s)*->SIG+TM(s)->TM(s)->?->Cluster425_2clades->Cluster446_2clades-><-Cluster773_2clades	bacteria>proteobacteria>alphaproteobacteria	1
<-NACHT||Cluster115_5clades->DOUBLECORTIN->?->SIG+TM->?->SIG+TM(s)*->SIG+TM(s)->TM(s)-><-Cluster422_2clades	bacteria>proteobacteria>alphaproteobacteria	1
<-NACHT||Cluster115_5clades->DOUBLECORTIN->?->SIG+TM->SIG+TM(s)*->SIG+TM(s)->TM(s)->?-><-?||?-><-SIG+MHYT+TM(s)+GGDEF+EAL	bacteria>proteobacteria>alphaproteobacteria	1
<-NACHT<-Cluster49_2clades<-SIG+TM(s)*	bacteria>proteobacteria>betaproteobacteria	1
<-NACHT<-Cluster49_2clades<-SIG+TM(s)*	bacteria>proteobacteria>gammaproteobacteria	1
<-NACHT<-SIG+TM(s)*	bacteria>proteobacteria>betaproteobacteria	1
<-NACHT<-SIG+TM(s)*<-Cluster57_2clades	bacteria>proteobacteria>gammaproteobacteria	1
<-NACHT<-SIG+TM(s)*<-Cluster57_2clades<-?<-?<-?<-?<-?<-SIG+TM	bacteria>proteobacteria>gammaproteobacteria	1
<-NACHT<-SIG+TM(s)*<-TM(s)<-SIG+TM(s)<-SIG+TM<-SIG+TM(s)	bacteria>proteobacteria>betaproteobacteria	1
<-ParA-Soj-PloopNTPase<-PSE<-HPT+HISKIN+CheW<-SFII-RAD3<-REC<-SIGMA-HTH<-ParA-Soj-PloopNTPase<-SIG+APATPase<-SIG+TM(s)*	bacteria>proteobacteria>gammaproteobacteria	1
<-ParA-Soj-PloopNTPase<-SIG+APATPase<-?<-?<-SIG+TM(s)*	bacteria>proteobacteria>alphaproteobacteria	1
<-ParA-Soj-PloopNTPase<-SIG+APATPase<-?<-SIG+TM(s)*<-TM(s)<-SIG+TM(s)<-SIG+TM<-SIG+TM(s)	bacteria>spirochaetes	1
<-ParA-Soj-PloopNTPase<-SIG+APATPase<-SIG+TM(s)*	bacteria>proteobacteria>gammaproteobacteria	1
<-ParA-Soj-PloopNTPase<-SIG+APATPase<-SIG+TM(s)*<-?<-SIG+NtrC-AAA+FIS-HTH<-CheC<-?<-CheC<-SIG+TM	bacteria>proteobacteria>alphaproteobacteria	1
<-ParA-Soj-PloopNTPase<-SIG+APATPase<-SIG+TM(s)*<-Cluster309_2clades<-Cluster112_5clades	bacteria>aquificae	1
<-ParA-Soj-PloopNTPase<-SIG+APATPase<-SIG+TM(s)*<-PSE<-?<-SIG+TM(s)<-SIG+TM<-SIG+TM(s)<-SIG+TM<-CheC	bacteria>spirochaetes	1
<-ParA-Soj-PloopNTPase<-SIG+APATPase<-SIG+TM(s)*<-TM(s)	bacteria>spirochaetes	1
<-ParA-Soj-PloopNTPase<-SIG+APATPase<-SIG+TM(s)*<-TM(s)<-SIG+TM(s)	bacteria>pvc group	1
<-ParA-Soj-PloopNTPase<-SIG+APATPase<-SIG+TM(s)*<-TM(s)<-SIG+TM(s)<-SIG+TM<-SIG+TM(s)<-?<-CheC<-CheC	bacteria>fcb group	1
<-ParA-Soj-PloopNTPase<-SIG+TM(s)*<-SIG+NtrC-AAA+FIS-HTH<-CheC<-?<-CheC<-SIG+TM	bacteria>proteobacteria>alphaproteobacteria	1
<-PilZ<-ParA-Soj-PloopNTPase<-SIG+APATPase<-SIG+TM(s)*	bacteria>firmicutes	1
<-PilZ<-ParA-Soj-PloopNTPase<-SIG+APATPase<-SIG+TM(s)*<-TM(s)<-SIG+TM(s)<-SIG+TM<-SIG+TM(s)<-SIG+TM<-REC	bacteria>firmicutes	1
<-PspC+LiaI-LiaF-TM*	archaea>euryarchaeota	1
<-PspC+LiaI-LiaF-TM*	bacteria>other unclassified bacteria	1
<-PspC+LiaI-LiaF-TM*<-SIG+TM(s)<-?<-?<-ABC-ATPase<-ABC-ATPase	archaea>euryarchaeota	1
<-PspC<-PspC<-?<-LiaI-LiaF-TM*	bacteria>firmicutes	1
<-REC||?->?->?->TM(s)->SIG+TM(s)*->SIG+TM->	bacteria>proteobacteria>gammaproteobacteria	1
<-REC<-?*	bacteria>fcb group	1
<-REC<-?<-?*	bacteria>firmicutes	1
<-REC<-?<-?*<-?<-?<-LiaI-LiaF-TM*	bacteria>firmicutes	1
<-REC<-?<-LiaI-LiaF-TM+Toast-rack*<-SIG+TM*	bacteria>firmicutes	1
<-REC<-?<-SIG+TM(s)<-LiaI-LiaF-TM+Toast-rack*	bacteria>fcb group	1
<-REC<-?<-SIG+TM+Toast-rack*<-?<-PspC<-?<-LiaI-LiaF-TM*	bacteria>firmicutes	1
<-REC<-?<-SIGMA-HTH<-ParA-Soj-PloopNTPase<-SIG+APATPase<-SIG+TM(s)*	bacteria>nitrospirae	1
<-REC<-CheRN-Alpha+CheR-Methylase<-REC<-CheW<-HPT+HISKIN+CheW<-?<-?<-SIG+TM(s)*<-TM(s)<-SIG+TM(s)<-SIG+TM<-SIG+TM(s)<-SIG+TM<-CheC<-CheC	bacteria>actinobacteria	1
<-REC<-HPT+HISKIN+CheW<-REC<-CheRN-Alpha+CheR-Methylase<-SIGMA-HTH<-ParA-Soj-PloopNTPase<-SIG+APATPase<-SIG+TM(s)*<-TM(s)<-SIG+TM(s)<-SIG+TM	bacteria>nitrospirae	1
<-REC<-HPT+HISKIN+CheW<-SFII-RAD3<-REC<-SIGMA-HTH<-ParA-Soj-PloopNTPase<-SIG+APATPase<-SIG+TM(s)*<-TM(s)<-SIG+TM(s)	bacteria>proteobacteria>gammaproteobacteria	1
<-REC<-HPT+HISKIN+CheW<-SFII-RAD3<-REC<-SIGMA-HTH<-ParA-Soj-PloopNTPase<-SIG+APATPase<-SIG+TM(s)*<-TM(s)<-SIG+TM(s)<-SIG+TM	bacteria>proteobacteria>gammaproteobacteria	1
<-REC<-HPT+HISKIN+CheW<-SFII-RAD3<-REC<-SIGMA-HTH<-ParA-Soj-PloopNTPase<-SIG+APATPase<-SIG+TM(s)*<-TM(s)<-SIG+TM(s)<-SIG+TM<-SIG+TM(s)	bacteria>proteobacteria>gammaproteobacteria	1
<-REC<-LiaI-LiaF-TM+Toast-rack*||?-><-Cluster422_2clades	bacteria>fcb group	1
<-REC<-PSE<-LiaI-LiaF-TM+Toast-rack*	bacteria>other unclassified bacteria	1
<-REC<-REC<-CheRN-Alpha+CheR-Methylase<-?<-SIGMA-HTH<-ParA-Soj-PloopNTPase<-SIG+APATPase<-SIG+TM(s)*<-TM(s)<-SIG+TM(s)<-SIG+TM<-SIG+TM(s)<-CheC<-CheC<-TM	bacteria>nitrospirae	1
<-REC<-SIG+CHASE3+TM+SHELIX+HISKIN<-SIG+TM(s)*<-?<-SIG+NtrC-AAA+FIS-HTH<-CheC<-?<-CheC<-SIG+TM	bacteria>proteobacteria>alphaproteobacteria	1
<-REC<-SIG+CHASE3+TM+SHELIX+HISKIN<-SIGMA-HTH<-ParA-Soj-PloopNTPase<-SIG+APATPase<-SIG+TM(s)*<-TM(s)	bacteria>proteobacteria>betaproteobacteria	1
<-REC<-SIG+TM(s)<-?*	bacteria>fcb group	1
<-REC<-SIG+TM(s)<-?<-?<-?*	bacteria>other unclassified bacteria	1
<-REC<-SIG+TM(s)<-LiaI-LiaF-TM+Toast-rack*	bacteria>acidobacteria	1
<-REC<-SIG+TM(s)<-LiaI-LiaF-TM+Toast-rack*	bacteria>proteobacteria>gammaproteobacteria	1
<-REC<-SIG+TM(s)<-LiaI-LiaF-TM+Toast-rack*<-LiaI-LiaF-TM*	bacteria>proteobacteria>betaproteobacteria	1
<-REC<-SIG+TM(s)<-LiaI-LiaF-TM+Toast-rack*<-LiaI-LiaF-TM+Toast-rack*	bacteria>fcb group	1
<-REC<-SIGMA-HTH<-?<-ParA-Soj-PloopNTPase<-SIG+APATPase<-SIG+TM(s)*<-TM(s)<-SIG+TM(s)<-SIG+TM<-SIG+TM(s)<-SIG+TM	bacteria>firmicutes	1
<-REC<-SIGMA-HTH<-ParA-Soj-PloopNTPase<-SIG+APATPase<-SIG+TM(s)*<-TM(s)<-SIG+TM(s)	bacteria>proteobacteria>deltaproteobacteria	1
<-SbcC(s)+SWACOS+SbcC<-FilH<-?<-RADICAL-SAM||SIG+TM(s)->TM(s)->SIG+TM(s)*->SIG+APATPase->ParA-Soj-PloopNTPase->?->SIGMA-HTH->REC->CheC->CheC->	bacteria>deferribacteres	1
<-SIG+APATPase<-?<-SIG+TM(s)*<-TM(s)	bacteria>proteobacteria>betaproteobacteria	1
<-SIG+APATPase<-SIG+TM(s)*	bacteria>proteobacteria>betaproteobacteria	1
<-SIG+APATPase<-SIG+TM(s)*	bacteria>proteobacteria>gammaproteobacteria	1
<-SIG+APATPase<-SIG+TM(s)*<-SIG+NtrC-AAA+FIS-HTH<-CheC<-?<-CheC<-SIG+TM	bacteria>proteobacteria>alphaproteobacteria	1
<-SIG+APATPase<-SIG+TM(s)*<-TM(s)	bacteria>pvc group	1
<-SIG+APATPase<-SIG+TM(s)*<-TM(s)<-SIG+TM(s)<-SIG+TM<-?<-SIG+TM(s)<-SIG+TM<-CheC	bacteria>proteobacteria>gammaproteobacteria	1
<-SIG+APATPase<-SIG+TM(s)*<-TM(s)<-SIG+TM(s)<-SIG+TM<-SIG+TM(s)	bacteria>chloroflexi	1
<-SIG+APATPase<-SIG+TM(s)*<-TM(s)<-SIG+TM(s)<-SIG+TM<-SIG+TM(s)	bacteria>fcb group	1
<-SIG+APATPase<-SIG+TM(s)*<-TM(s)<-SIG+TM(s)<-SIG+TM<-SIG+TM(s)	bacteria>other unclassified bacteria	1
<-SIG+APATPase<-SIG+TM(s)*<-TM(s)<-SIG+TM(s)<-SIG+TM<-SIG+TM(s)<-SIG+TM<-CheC<-CheC	bacteria>proteobacteria>gammaproteobacteria	1
<-SIG+BetaPropeller<-?<-?<-SIGMA-HTH<-PilZ<-ParA-Soj-PloopNTPase<-SIG+APATPase<-SIG+TM(s)*<-TM(s)<-SIG+TM<-SIG+TM(s)<-SIG+TM	bacteria>firmicutes	1
<-SIG+BetaPropeller<-SIG+BetaPropeller||?-><-SIGMA-HTH<-ParA-Soj-PloopNTPase<-SIG+APATPase<-SIG+TM(s)*<-TM(s)<-SIG+TM(s)<-SIG+TM<-SIG+TM(s)<-SIG+TM<-CheC<-CheC	bacteria>proteobacteria>deltaproteobacteria	1
<-SIG+BetaPropeller<-SIG+BetaPropeller<-?<-SIGMA-HTH<-?<-SIG+APATPase<-SIG+TM(s)*<-TM(s)<-SIG+TM<-SIG+TM(s)	bacteria>firmicutes	1
<-SIG+BetaPropeller<-SIG+BetaPropeller<-?<-SIGMA-HTH<-?<-SIG+APATPase<-SIG+TM(s)*<-TM(s)<-SIG+TM<-SIG+TM(s)<-SIG+TM<-TM<-TM+OmpA<-SIG+TM(s)	bacteria>firmicutes	1
<-SIG+BetaPropeller<-SIG+BetaPropeller<-?<-SIGMA-HTH<-ParA-Soj-PloopNTPase<-SIG+APATPase<-SIG+TM(s)*<-TM(s)<-SIG+TM(s)<-SIG+TM<-SIG+TM(s)	bacteria>proteobacteria>deltaproteobacteria	1
<-SIG+BetaPropeller<-SIG+BetaPropeller<-SIG+TM(s)*<-TM(s)<-SIG+TM(s)<-SIG+TM	bacteria>proteobacteria>betaproteobacteria	1
<-SIG+BetaPropeller<-SIG+BetaPropeller<-SIG+TM(s)*<-TM(s)<-SIG+TM(s)<-SIG+TM	bacteria>proteobacteria>gammaproteobacteria	1
<-SIG+BetaPropeller<-SIG+BetaPropeller<-SIGMA-HTH<-PilZ<-ParA-Soj-PloopNTPase<-SIG+APATPase<-SIG+TM(s)*	bacteria>firmicutes	1
<-SIG+BetaPropeller<-SIG+BetaPropeller<-SIGMA-HTH<-SIG+TM(s)*<-TM(s)<-SIG+TM(s)<-SIG+TM<-SIG+TM(s)<-SIG+TM<-REC<-CheC	bacteria>firmicutes	1
<-SIG+BetaPropeller<-SIG+BetaPropeller<-SIGMA-HTH<-SIG+TM(s)*<-TM(s)<-SIG+TM(s)<-SIG+TM<-SIG+TM(s)<-SIG+TM<-TM<-TM+OmpA	bacteria>firmicutes	1
<-SIG+NtrC-AAA+FIS-HTH||TM(s)->SIG+TM(s)*->	bacteria>proteobacteria>deltaproteobacteria	1
<-SIG+Phytase-like<-?<-LiaI-LiaF-TM+Toast-rack*<-?<-PspC	bacteria>fcb group	1
<-SIG+SAF<-SIG+BetaPropeller<-SIG+BetaPropeller<-?<-SIGMA-HTH<-ParA-Soj-PloopNTPase<-SIG+APATPase<-SIG+TM(s)*<-TM(s)<-SIG+TM(s)<-SIG+TM<-SIG+TM(s)<-SIG+TM<-CheC<-CheC	bacteria>proteobacteria>deltaproteobacteria	1
<-SIG+TarH+TM+HAMP+MA<-?<-ParA-Soj-PloopNTPase<-SIG+APATPase<-SIG+TM(s)*<-?<-SIG+TM(s)<-?<-Cluster192_2clades	bacteria>proteobacteria>deltaproteobacteria	1
<-SIG+TarH+TM+HAMP+MA<-CheW<-SIGMA-HTH<-?<-SIG+APATPase<-SIG+TM(s)*<-TM(s)	bacteria>proteobacteria>betaproteobacteria	1
<-SIG+TM(s)*	bacteria>actinobacteria	1
<-SIG+TM(s)*	bacteria>pvc group	1
<-SIG+TM(s)*	bacteria>spirochaetes	1
<-SIG+TM(s)*||?->?->?->?->?->?->SIG+APATPase->	bacteria>proteobacteria>epsilonproteobacteria	1
<-SIG+TM(s)*<-?<-?<-?<-?||FHA->NACHT->TET-TPase->	bacteria>proteobacteria>betaproteobacteria	1
<-SIG+TM(s)*<-?<-?<-CR-REase10<-CR-ATPase7	bacteria>proteobacteria>gammaproteobacteria	1
<-SIG+TM(s)*<-?<-REC<-?<-REC<-CheRN-Alpha+CheR-Methylase<-REC	bacteria>actinobacteria	1
<-SIG+TM(s)*<-?<-SIGMA-HTH	bacteria>armatimonadetes	1
<-SIG+TM(s)*<-Cluster263_2clades	bacteria>others	1
<-SIG+TM(s)*<-Cluster263_2clades<-?<-?<-?<-PSE<-DOUBLECORTIN<-?<-SIG+BetaPropeller	bacteria>others	1
<-SIG+TM(s)*<-Cluster57_2clades	bacteria>proteobacteria>gammaproteobacteria	1
<-SIG+TM(s)*<-Cluster57_2clades<-?<-?<-?<-SIG+TM	bacteria>proteobacteria>gammaproteobacteria	1
<-SIG+TM(s)*<-CR-ATPase7	bacteria>proteobacteria>gammaproteobacteria	1
<-SIG+TM(s)*<-CR-ATPase7<-?||SIGMA-HTH->SIG+ACET->	bacteria>proteobacteria>gammaproteobacteria	1
<-SIG+TM(s)*<-PSE<-SIG+TM(s)<-SIG+TM<-SIG+TM(s)<-CheC	bacteria>proteobacteria>gammaproteobacteria	1
<-SIG+TM(s)*<-PSE<-SIG+TM(s)<-SIG+TM<-SIG+TM(s)<-CheC<-CheC	bacteria>proteobacteria>gammaproteobacteria	1
<-SIG+TM(s)*<-PYRIN<-Cluster27_3clades<-AraC-HTH	bacteria>proteobacteria>gammaproteobacteria	1
<-SIG+TM(s)*<-REC<-SIG+CHASE3+TM+SHELIX+HISKIN<-?<-TM(s)<-SIG+TM(s)<-SIG+TM	bacteria>actinobacteria	1
<-SIG+TM(s)*<-SIG+TM(s)<-?<-CheC<-CheC<-TM	bacteria>pvc group	1
<-SIG+TM(s)*<-SIG+TM<-IONCHANNEL	bacteria>proteobacteria>alphaproteobacteria	1
<-SIG+TM(s)*<-TM(s)	bacteria>other proteobacteria	1
<-SIG+TM(s)*<-TM(s)	bacteria>proteobacteria>deltaproteobacteria	1
<-SIG+TM(s)*<-TM(s)	bacteria>spirochaetes	1
<-SIG+TM(s)*<-TM(s)<-?<-PSE<-SIG+TM<-SIG+TM(s)	bacteria>other unclassified bacteria	1
<-SIG+TM(s)*<-TM(s)<-?<-PSYN	bacteria>proteobacteria>betaproteobacteria	1
<-SIG+TM(s)*<-TM(s)<-SIG+TM(s)	bacteria>proteobacteria>gammaproteobacteria	1
<-SIG+TM(s)*<-TM(s)<-SIG+TM(s)<-SIG+TM	bacteria>fcb group	1
<-SIG+TM(s)*<-TM(s)<-SIG+TM(s)<-SIG+TM	bacteria>nitrospirae	1
<-SIG+TM(s)*<-TM(s)<-SIG+TM(s)<-SIG+TM(s)<-SIG+TM<-CheC<-CheC<-TM	bacteria>actinobacteria	1
<-SIG+TM(s)*<-TM(s)<-SIG+TM(s)<-SIG+TM<-?||?-><-SIG+TM(s)<-CheC	bacteria>proteobacteria>gammaproteobacteria	1
<-SIG+TM(s)*<-TM(s)<-SIG+TM(s)<-SIG+TM<-PSE<-SIG+TM<-CheC<-CheC	bacteria>actinobacteria	1
<-SIG+TM(s)*<-TM(s)<-SIG+TM(s)<-SIG+TM<-SIG+TM(s)	bacteria>proteobacteria>gammaproteobacteria	1
<-SIG+TM(s)*<-TM(s)<-SIG+TM(s)<-SIG+TM<-SIG+TM(s)<-?<-CheC<-CheC	bacteria>nitrospirae	1
<-SIG+TM(s)*<-TM(s)<-SIG+TM(s)<-SIG+TM<-SIG+TM(s)<-CheC<-CheC<-Cluster120_5clades	bacteria>proteobacteria>betaproteobacteria	1
<-SIG+TM(s)*<-TM(s)<-SIG+TM(s)<-SIG+TM<-SIG+TM(s)<-SIG+TM||?-><-CheC	bacteria>actinobacteria	1
<-SIG+TM(s)*<-TM(s)<-SIG+TM(s)<-SIG+TM<-SIG+TM(s)<-SIG+TM<-CheC	bacteria>other unclassified bacteria	1
<-SIG+TM(s)*<-TM(s)<-SIG+TM(s)<-SIG+TM<-SIG+TM(s)<-SIG+TM<-REC<-CheC	bacteria>firmicutes	1
<-SIG+TM(s)*<-TM(s)<-SIG+TM(s)<-SIG+TM<-SIG+TM(s)<-SIG+TM<-TM	bacteria>firmicutes	1
<-SIG+TM(s)*<-TM(s)<-SIG+TM(s)<-SIG+TM<-TPR(s)	bacteria>proteobacteria>betaproteobacteria	1
<-SIG+TM(s)*<-TPR	bacteria>proteobacteria>alphaproteobacteria	1
<-SIG+TM(s)*<-TPR	bacteria>proteobacteria>betaproteobacteria	1
<-SIG+TM(s)*<-TPR<-?<-?<-?<-CR-ATPase7||NACHT->	bacteria>proteobacteria>gammaproteobacteria	1
<-SIG+TM(s)*<-TPR<-?<-CR-REase10<-?<-CR-ATPase7	bacteria>proteobacteria>gammaproteobacteria	1
<-SIG+TM(s)*<-TPR<-?<-CR-REase10<-CR-ATPase7	bacteria>proteobacteria>alphaproteobacteria	1
<-SIG+TM(s)*<-TPR<-?<-CR-REase10<-CR-ATPase7	bacteria>proteobacteria>deltaproteobacteria	1
<-SIG+TM(s)*<-TPR<-?<-CR-REase10<-CR-ATPase7||?->?->TPR->	bacteria>proteobacteria>betaproteobacteria	1
<-SIG+TM(s)*<-TPR<-?<-FHA+TM	bacteria>proteobacteria>alphaproteobacteria	1
<-SIG+TM(s)<-?<-?<-Cluster354_2clades<-?<-SIG+TM(s)*<-?<-NACHT<-?<-TM(s)<-SIG+TM(s)<-?<-DOUBLECORTIN	bacteria>proteobacteria>epsilonproteobacteria	1
<-SIG+TM(s)<-?<-SIG+TM(s)*<-?||?-><-SIG+TM<-IONCHANNEL	bacteria>proteobacteria>alphaproteobacteria	1
<-SIG+TM(s)<-?<-SIG+TM(s)*<-?<-SIG+TM<-IONCHANNEL	bacteria>proteobacteria>alphaproteobacteria	1
<-SIG+TM(s)<-?<-TM+OmpA<-SIG+TM(s)<-?<-ParA-Soj-PloopNTPase<-SIG+APATPase<-SIG+TM(s)*<-TM(s)<-SIG+TM(s)<-SIG+TM<-SIG+TM(s)	bacteria>nitrospirae	1
<-SIG+TM(s)<-Cluster24_2clades<-?<-?<-Cluster59_2clades<-NACHT<-Cluster49_2clades<-SIG+TM(s)*<-PYRIN<-Cluster27_3clades<-AraC-HTH	bacteria>proteobacteria>gammaproteobacteria	1
<-SIG+TM(s)<-Cluster24_2clades<-?<-Cluster59_2clades<-NACHT<-Cluster49_2clades<-SIG+TM(s)*<-PYRIN<-Cluster27_3clades<-AraC-HTH	bacteria>proteobacteria>gammaproteobacteria	1
<-SIG+TM(s)<-HPT+HISKIN+CheW<-SFII-RAD3<-REC<-SIGMA-HTH<-ParA-Soj-PloopNTPase<-SIG+APATPase<-SIG+TM(s)*<-TM(s)<-?<-SIG+MHYT+TM(s)+GGDEF+EAL	bacteria>proteobacteria>gammaproteobacteria	1
<-SIG+TM(s)<-HPT+HISKIN+CheW<-SFII-RAD3<-REC<-SIGMA-HTH<-ParA-Soj-PloopNTPase<-SIG+APATPase<-SIG+TM(s)*<-TM(s)<-PSE<-?<-?<-?<-SIG+MHYT+TM(s)+GGDEF+EAL	bacteria>proteobacteria>gammaproteobacteria	1
<-SIG+TM(s)<-LiaI-LiaF-TM+Toast-rack*<-?<-?||?-><-Cluster440_3clades	bacteria>fcb group	1
<-SIG+TM(s)<-PSE<-HPT+HISKIN+CheW<-SFII-RAD3<-REC<-SIGMA-HTH<-ParA-Soj-PloopNTPase<-SIG+APATPase<-SIG+TM(s)*<-TM(s)<-SIG+TM(s)<-SIG+TM<-SIG+TM(s)<-SIG+TM<-CheC<-CheC	bacteria>proteobacteria>gammaproteobacteria	1
<-SIG+TM(s)<-REC<-HPT+HISKIN+CheW<-SFII-RAD3<-REC<-SIGMA-HTH<-SIG+APATPase<-SIG+TM(s)*<-TM(s)<-SIG+TM(s)<-SIG+TM<-SIG+TM(s)<-SIG+TM<-CheC<-CheC	bacteria>proteobacteria>gammaproteobacteria	1
<-SIG+TM(s)<-REC<-PSE<-SFII-RAD3<-REC<-SIGMA-HTH<-ParA-Soj-PloopNTPase<-SIG+APATPase<-SIG+TM(s)*<-TM(s)<-SIG+TM(s)<-SIG+TM<-SIG+TM(s)<-SIG+TM<-CheC<-CheC	bacteria>proteobacteria>gammaproteobacteria	1
<-SIG+TM(s)<-SIG+TM(s)*<-SIG+TM	bacteria>proteobacteria>alphaproteobacteria	1
<-SIG+TM(s)<-SIG+TM(s)*<-TM(s)<-?<-Cluster774_2clades	bacteria>proteobacteria>betaproteobacteria	1
<-SIG+TM(s)<-SIG+TM<-SIG+TM(s)<-?<-?<-?<-NACHT<-SIG+TM(s)*<-Cluster57_2clades<-?<-?<-?<-?<-?<-SIG+TM	bacteria>proteobacteria>gammaproteobacteria	1
<-SIG+TM(s)<-SIG+TM<-SIG+TM(s)<-?<-?<-?<-NACHT<-SIG+TM(s)*<-Cluster57_2clades<-?<-?<-?<-?<-SIG+TM	bacteria>proteobacteria>gammaproteobacteria	1
<-SIG+TM(s)<-SIG+TM<-SIG+TM(s)<-?<-?<-TET-TPase<-NACHT<-SIG+TM(s)*<-?<-?||?-><-SIG+TM	bacteria>proteobacteria>gammaproteobacteria	1
<-SIG+TM(s)<-SIG+TM<-SIG+TM(s)<-?<-?<-TET-TPase<-NACHT<-SIG+TM(s)*<-Cluster57_2clades	bacteria>proteobacteria>gammaproteobacteria	1
<-SIG+TM(s)<-SIG+TM<-SIG+TM(s)<-?<-REC<-?||SIG+TM(s)*->Cluster27_3clades->?->Cluster623_2clades->?->SIG+TM->	bacteria>proteobacteria>gammaproteobacteria	1
<-SIG+TM(s)<-SIG+TM<-SIG+TM(s)<-Cluster103_2clades<-Cluster179_2clades<-TET-TPase<-NACHT<-SIG+TM(s)*<-Cluster57_2clades	bacteria>proteobacteria>betaproteobacteria	1
<-SIG+TM(s)<-SIG+TM<-SIG+TM(s)<-Cluster103_2clades<-Cluster179_2clades<-TET-TPase<-NACHT<-SIG+TM(s)*<-Cluster57_2clades||?-><-REC||?->Cluster27_3clades->	bacteria>proteobacteria>betaproteobacteria	1
<-SIG+TM(s)<-SIG+TM<-SIG+TM(s)<-Cluster24_2clades<-?<-Cluster59_2clades<-NACHT<-SIG+TM(s)*<-PYRIN	bacteria>proteobacteria>betaproteobacteria	1
<-SIG+TM(s)<-SIG+TM<-SIG+TM(s)<-Cluster24_2clades<-?<-Cluster59_2clades<-NACHT<-SIG+TM(s)*<-PYRIN<-Cluster27_3clades	bacteria>proteobacteria>betaproteobacteria	1
<-SIG+TM(s)<-SIG+TM<-SIG+TM(s)<-PSE<-?<-TET-TPase<-NACHT<-FHA<-SIG+TM(s)*<-CR-ATPase7	bacteria>proteobacteria>gammaproteobacteria	1
<-SIG+TM(s)<-SIGMA-HTH<-?<-SIG+TM(s)*	bacteria>other unclassified bacteria	1
<-SIG+TM(s)<-SIGMA-HTH<-ParA-Soj-PloopNTPase<-SIG+APATPase<-SIG+TM(s)*<-TM(s)||Thymidylate-synthase->Cluster372_2clades->	bacteria>proteobacteria>betaproteobacteria	1
<-SIG+TM(s)<-SIGMA-HTH<-ParA-Soj-PloopNTPase<-SIG+APATPase<-SIG+TM(s)*<-TM(s)||Thymidylate-synthase->Cluster372_2clades-><-?<-?<-?<-Cluster673_2clades	bacteria>proteobacteria>betaproteobacteria	1
<-SIG+TM||TM->?->?->SIG+TM(s)->?->?->SIG+TM(s)*->SIG+TM(s)->TM(s)->?-><-?<-TM<-SIG+SAF<-SIG+BetaPropeller	bacteria>proteobacteria>alphaproteobacteria	1
<-SIG+TM||TM->CheC->?->?-><-TM(s)<-SIG+TM(s)<-SIG+TM(s)*||?-><-?<-SIG+TM<-?<-DOUBLECORTIN<-Cluster115_5clades	bacteria>proteobacteria>alphaproteobacteria	1
<-SIG+TM<-?<-?<-?<-?<-Cluster27_3clades<-SIG+TM<-SIG+TM(s)*	bacteria>proteobacteria>betaproteobacteria	1
<-SIG+TM<-?<-?<-Cluster301_2clades||SIG+TPR-><-Cluster154_3clades<-TM<-SIG+TM(s)*<-TPR<-Cluster172_2clades<-FHA+TM	bacteria>proteobacteria>gammaproteobacteria	1
<-SIG+TM<-?<-SIG+TM(s)*	bacteria>proteobacteria>gammaproteobacteria	1
<-SIG+TM<-SIG+TM(s)*	bacteria>proteobacteria>gammaproteobacteria	1
<-SIG+TM<-SIG+TM(s)*<-?<-TM(s)<-?<-?<-SFII-RAD3<-REC<-REC	bacteria>proteobacteria>gammaproteobacteria	1
<-SIG+TM<-SIG+TM(s)*<-TM(s)||?-><-SFII-RAD3<-REC<-REC<-CheRN-Alpha+CheR-Methylase	bacteria>proteobacteria>gammaproteobacteria	1
<-SIG+TM<-SIG+TM(s)*<-TM(s)<-?<-?<-SFII-RAD3<-REC	bacteria>proteobacteria>gammaproteobacteria	1
<-SIG+TM<-SIG+TM(s)*<-TM(s)<-?<-?<-TM+OmpA<-SIG+TM(s)<-Cluster366_2clades<-Cluster485_2clades	bacteria>proteobacteria>gammaproteobacteria	1
<-SIG+TM<-SIG+TM(s)*<-TM(s)<-SFII-RAD3<-REC	bacteria>proteobacteria>gammaproteobacteria	1
<-SIG+TM<-SIG+TM(s)*<-TM(s)<-SFII-RAD3<-REC<-REC	bacteria>proteobacteria>gammaproteobacteria	1
<-SIG+TM<-SIG+TM(s)<-?<-?<-?<-NACHT<-Cluster49_2clades<-SIG+TM(s)*	bacteria>proteobacteria>gammaproteobacteria	1
<-SIG+TM<-SIG+TM(s)<-Cluster24_2clades<-?||?-><-NACHT<-Cluster49_2clades<-SIG+TM(s)*<-PYRIN<-Cluster27_3clades<-AraC-HTH	bacteria>proteobacteria>betaproteobacteria	1
<-SIG+TM<-SIG+TM(s)<-Cluster24_2clades<-?<-?<-NACHT<-Cluster49_2clades<-SIG+TM(s)*<-?<-PYRIN<-Cluster27_3clades	bacteria>proteobacteria>betaproteobacteria	1
<-SIG+TM<-SIG+TM(s)<-Cluster24_2clades<-?<-Cluster59_2clades<-NACHT<-Cluster49_2clades<-SIG+TM(s)*<-PYRIN<-Cluster27_3clades<-AraC-HTH	bacteria>proteobacteria>betaproteobacteria	1
<-SIG+TM<-SIG+TM(s)<-Cluster24_2clades<-?<-Cluster59_2clades<-NACHT<-Cluster49_2clades<-SIG+TM(s)*<-PYRIN<-Cluster27_3clades<-AraC-HTH||?-><-?<-?<-?<-?<-?<-?<-?<-?<-SIG+TM(s)*<-TM(s)<-SIG+TM(s)<-SIG+TM<-SIG+TM(s)<-CheC<-CheC	bacteria>proteobacteria>betaproteobacteria	1
<-SIG+TM<-SIG+TM(s)<-Cluster24_2clades<-SIG+TM(s)*<-TM(s)	bacteria>proteobacteria>betaproteobacteria	1
<-SIG+TPR<-SIG+TM(s)*	bacteria>proteobacteria>alphaproteobacteria	1
<-SIGMA-HTH||CR-ATPase7->SIG+TM(s)*->FHA->NACHT-><-?||?->?->Cluster63_2clades->SIG+TM(s)->	bacteria>proteobacteria>gammaproteobacteria	1
<-SIGMA-HTH<-?<-?<-SIG+TM(s)*<-TM(s)<-SIG+TM(s)<-SIG+TM<-SIG+TM(s)<-SIG+TM<-CheC	bacteria>other unclassified bacteria	1
<-SIGMA-HTH<-?<-CheD<-CheC<-PilZ<-ParA-Soj-PloopNTPase<-SIG+APATPase<-SIG+TM(s)*<-TM(s)<-SIG+TM(s)<-SIG+TM<-SIG+TM(s)<-SIG+TM	bacteria>firmicutes	1
<-SIGMA-HTH<-?<-CheD<-CheC<-REC<-ParA-Soj-PloopNTPase<-SIG+APATPase<-SIG+TM(s)*<-TM(s)<-SIG+TM(s)<-SIG+TM<-SIG+TM(s)<-SIG+TM<-REC<-CheC	bacteria>firmicutes	1
<-SIGMA-HTH<-?<-ParA-Soj-PloopNTPase<-SIG+APATPase<-SIG+TM(s)*	bacteria>other unclassified bacteria	1
<-SIGMA-HTH<-?<-ParA-Soj-PloopNTPase<-SIG+APATPase<-SIG+TM(s)*<-TM(s)<-SIG+TM(s)<-SIG+TM<-?<-SIG+TM(s)	bacteria>proteobacteria>zetaproteobacteria	1
<-SIGMA-HTH<-?<-ParA-Soj-PloopNTPase<-SIG+APATPase<-SIG+TM(s)*<-TM(s)<-SIG+TM(s)<-SIG+TM<-SIG+TM(s)<-?<-CheC	bacteria>fcb group	1
<-SIGMA-HTH<-?<-ParA-Soj-PloopNTPase<-SIG+APATPase<-SIG+TM(s)*<-TM(s)<-SIG+TM(s)<-SIG+TM<-SIG+TM(s)<-?<-CheC<-CheC	bacteria>proteobacteria>zetaproteobacteria	1
<-SIGMA-HTH<-?<-ParA-Soj-PloopNTPase<-SIG+APATPase<-SIG+TM(s)*<-TM(s)<-SIG+TM(s)<-SIG+TM<-SIG+TM(s)<-SIG+TM<-CheC<-CheC	bacteria>fcb group	1
<-SIGMA-HTH<-?<-SIG+APATPase<-SIG+TM(s)*<-TM(s)<-SIG+TM<-SIG+TM(s)||?-><-SIG+TM<-TM<-TM+OmpA	bacteria>firmicutes	1
<-SIGMA-HTH<-?<-SIG+APATPase<-SIG+TM(s)*<-TM(s)<-SIG+TM<-SIG+TM(s)<-SIG+TM<-TM<-TM+OmpA<-SIG+TM(s)	bacteria>firmicutes	1
<-SIGMA-HTH<-?<-SIG+TM(s)*<-TM(s)	bacteria>other unclassified bacteria	1
<-SIGMA-HTH<-?<-SIG+TM(s)*<-TM(s)<-SIG+TM(s)<-SIG+TM<-SIG+TM(s)<-SIG+TM<-CheC	bacteria>other unclassified bacteria	1
<-SIGMA-HTH<-CheD<-CheC<-PilZ<-ParA-Soj-PloopNTPase<-?<-SIG+APATPase<-SIG+TM(s)*<-TM(s)<-SIG+TM(s)<-SIG+TM<-SIG+TM(s)<-?<-REC<-CheW	bacteria>thermotogae	1
<-SIGMA-HTH<-CheD<-CheC<-PilZ<-ParA-Soj-PloopNTPase<-SIG+APATPase<-SIG+TM(s)*<-TM(s)<-SIG+TM(s)<-SIG+TM<-SIG+TM(s)<-?<-REC<-CheW	bacteria>thermotogae	1
<-SIGMA-HTH<-ParA-Soj-PloopNTPase<-SIG+APATPase<-SIG+TM(s)*<-?<-?<-TM(s)<-SIG+TM(s)<-SIG+TM<-SIG+TM(s)<-SIG+TM	bacteria>proteobacteria>gammaproteobacteria	1
<-SIGMA-HTH<-ParA-Soj-PloopNTPase<-SIG+APATPase<-SIG+TM(s)*<-?<-TM(s)<-SIG+TM(s)<-SIG+TM<-SIG+TM(s)<-SIG+TM<-CheC	bacteria>proteobacteria>gammaproteobacteria	1
<-SIGMA-HTH<-ParA-Soj-PloopNTPase<-SIG+APATPase<-SIG+TM(s)*<-TM(s)||Thymidylate-synthase->Cluster372_2clades->	bacteria>proteobacteria>betaproteobacteria	1
<-SIGMA-HTH<-ParA-Soj-PloopNTPase<-SIG+APATPase<-SIG+TM(s)*<-TM(s)<-SIG+TM(s)<-SIG+TM<-SIG+TM(s)<-SIG+TM<-CheC<-CheC	bacteria>nitrospirae	1
<-SIGMA-HTH<-ParA-Soj-PloopNTPase<-SIG+APATPase<-SIG+TM(s)*<-TM(s)<-SIG+TM(s)<-SIG+TM<-SIG+TM(s)<-SIG+TM<-CheC<-TM	bacteria>firmicutes	1
<-SIGMA-HTH<-ParA-Soj-PloopNTPase<-SIG+APATPase<-SIG+TM(s)*<-TM(s)<-SIG+TM(s)<-SIG+TM<-SIG+TM(s)<-SIG+TM<-REC<-CheC	bacteria>firmicutes	1
<-SIGMA-HTH<-PilZ<-ParA-Soj-PloopNTPase<-SIG+APATPase<-SIG+TM(s)*	bacteria>firmicutes	1
<-SIGMA-HTH<-PilZ<-ParA-Soj-PloopNTPase<-SIG+APATPase<-SIG+TM(s)*<-TM(s)<-SIG+TM<-SIG+TM(s)<-SIG+TM<-TM<-TM+OmpA<-SIG+TM(s)	bacteria>firmicutes	1
<-SIGMA-HTH<-SIG+TM(s)*	bacteria>pvc group	1
<-SIGMA-HTH<-SIG+TM<-SIG+TM(s)*||?-><-TM(s)<-SFII-RAD3<-REC<-SIG+TarH+TM+HAMP+MA<-REC<-CheRN-Alpha+CheR-Methylase	bacteria>proteobacteria>gammaproteobacteria	1
<-SIGMA-HTH<-SIG+TM<-SIG+TM(s)*<-TM(s)<-SFII-RAD3<-REC<-REC<-CheRN-Alpha+CheR-Methylase<-SIG+TarH+TM+HAMP+MA<-SIG+TarH+TM+HAMP+MA	bacteria>proteobacteria>gammaproteobacteria	1
<-TET-TPase<-NACHT<-FHA<-?<-?<-SIG+TM(s)*	bacteria>proteobacteria>betaproteobacteria	1
<-TET-TPase<-NACHT<-FHA<-SIG+TM(s)*	bacteria>proteobacteria>gammaproteobacteria	1
<-TET-TPase<-NACHT<-FHA<-SIG+TM(s)*<-CR-ATPase7	bacteria>proteobacteria>gammaproteobacteria	1
<-TET-TPase<-NACHT<-SIG+TM(s)*<-Cluster57_2clades<-?<-?<-?<-SIG+TM	bacteria>proteobacteria>gammaproteobacteria	1
<-TM(s)<-?<-?<-SIGMA-HTH<-ParA-Soj-PloopNTPase<-SIG+APATPase<-SIG+TM(s)*	bacteria>proteobacteria>alphaproteobacteria	1
<-TM(s)<-PSE<-SIG+TM<-SIG+TM(s)<-?<-?<-TET-TPase<-NACHT<-SIG+TM(s)*<-Cluster57_2clades<-?<-?<-?<-SIG+TM	bacteria>proteobacteria>gammaproteobacteria	1
<-TM(s)<-SIG+TM(s)<-SIG+TM(s)*<-?<-SIG+TM(s)<-?<-?<-TM||SIG+TM->	bacteria>proteobacteria>alphaproteobacteria	1
<-TM(s)<-SIG+TM(s)<-SIG+TM(s)*<-?<-SIG+TM<-?<-DOUBLECORTIN<-Cluster115_5clades||NACHT->	bacteria>proteobacteria>alphaproteobacteria	1
<-TM(s)<-SIG+TPR<-Cluster154_3clades<-TM<-SIG+TM(s)*<-TPR<-Cluster172_2clades<-FHA+TM	bacteria>proteobacteria>alphaproteobacteria	1
<-TM(s)<-SIG+TPR<-Cluster154_3clades<-TM<-SIG+TM(s)*<-TPR<-Cluster172_2clades<-FHA+TM<-Cluster251_2clades	bacteria>proteobacteria>alphaproteobacteria	1
<-TM+OmpA<-SIG+TM(s)<-SIGMA-HTH<-ParA-Soj-PloopNTPase<-SIG+APATPase<-SIG+TM(s)*<-TM(s)<-?<-SFII-RAD3<-REC	bacteria>proteobacteria>betaproteobacteria	1
<-TM+OmpA<-SIG+TM(s)<-SIGMA-HTH<-ParA-Soj-PloopNTPase<-SIG+APATPase<-SIG+TM(s)*<-TM(s)<-SIG+TM(s)<-SIG+TM	bacteria>proteobacteria>gammaproteobacteria	1
<-TM<-REC<-PSE<-ParA-Soj-PloopNTPase<-SIG+APATPase<-SIG+TM(s)*<-TM(s)<-SIG+TM(s)	bacteria>proteobacteria>deltaproteobacteria	1
<-TM<-REC<-SIGMA-HTH<-ParA-Soj-PloopNTPase<-SIG+APATPase<-SIG+TM(s)*<-TM(s)<-SIG+TM(s)<-SIG+PTSEIIA1	bacteria>proteobacteria>deltaproteobacteria	1
<-TM<-SIG+TM(s)*	bacteria>proteobacteria>gammaproteobacteria	1
<-TM<-SIGMA-HTH<-ParA-Soj-PloopNTPase<-SIG+APATPase<-SIG+TM(s)*<-TM(s)<-SIG+TM(s)<-SIG+TM<-SIG+TM(s)<-SIG+TM<-CheC<-CheC	bacteria>proteobacteria>deltaproteobacteria	1
<-TPR<-?<-?<-?<-SIG+TM(s)*<-TPR<-?<-CR-REase10<-?<-CR-ATPase7||NACHT->	bacteria>proteobacteria>gammaproteobacteria	1
<-TRAM+METHYLASE<-SIG+TM(s)*<-?<-CheC<-SIG+TM<-?<-DOUBLECORTIN<-?<-Cluster120_5clades	bacteria>firmicutes	1
ABC-ATPase->?->?->?->Cluster562_2clades->?->LiaI-LiaF-TM+Toast-rack*->?->REC->	bacteria>firmicutes	1
ABC-ATPase->?->PspC->LiaI-LiaF-TM+Toast-rack*->	bacteria>other unclassified bacteria	1
ABC-ATPase-><-?<-SIGMA-HTH<-ParA-Soj-PloopNTPase<-SIG+APATPase<-SIG+TM(s)*<-TM(s)<-SIG+TM(s)<-SIG+TM	bacteria>fcb group	1
ABC-ATPase(s)-><-?<-LiaI-LiaF-TM+Toast-rack*	bacteria>firmicutes	1
AraC-HTH->Cluster27_3clades->PSE->SIG+TM(s)*->Cluster49_2clades->NACHT->Cluster59_2clades->?->Cluster24_2clades->SIG+TM(s)->SIG+TM->	bacteria>proteobacteria>gammaproteobacteria	1
AraC-HTH->Cluster27_3clades->PYRIN->SIG+TM(s)*->Cluster49_2clades->NACHT->Cluster59_2clades->?->Cluster24_2clades->SIG+TM(s)->SIG+TM->	bacteria>proteobacteria>betaproteobacteria	1
ATP-LIGASE+HhH-RADC+BRCT->?->?-><-?||?->?->?-><-SIG+TM(s)*<-TM(s)<-SIG+TM(s)<-SIG+TM<-SIG+TM(s)	bacteria>proteobacteria>deltaproteobacteria	1
CheC->?->?->SIG+TM(s)->SIG+TM->SIG+TM(s)->TM(s)->SIG+TM(s)*->SIG+APATPase->?->?->SIGMA-HTH->	bacteria>other unclassified bacteria	1
CheC->?->SIG+TM(s)->SIG+TM->SIG+TM(s)->?->TM(s)->SIG+TM(s)*->SIG+APATPase->SIG+BetaPropeller->	bacteria>firmicutes	1
CheC->?->SIG+TM(s)->SIG+TM->SIG+TM(s)->TM(s)->SIG+TM(s)*->?->SIG+APATPase->SIG+BetaPropeller->	bacteria>firmicutes	1
CheC->?->SIG+TM(s)->SIG+TM->SIG+TM(s)->TM(s)->SIG+TM(s)*->SIG+APATPase->SIG+BetaPropeller->	bacteria>firmicutes	1
CheC->?->SIG+TM(s)->SIGMA-HTH->TPR->?-><-TPR(s)<-SIG+TM(s)*<-TM(s)<-SIG+TM(s)<-SIG+TM	bacteria>proteobacteria>alphaproteobacteria	1
CheC->CheC->?->SIG+TM(s)->SIG+TM->SIG+TM(s)->TM(s)->SIG+TM(s)*->?->ParA-Soj-PloopNTPase->SIGMA-HTH->	bacteria>proteobacteria>deltaproteobacteria	1
CheC->CheC->?->SIG+TM(s)->SIG+TM->SIG+TM(s)->TM(s)->SIG+TM(s)*->SIG+APATPase->ParA-Soj-PloopNTPase->SIGMA-HTH->	bacteria>thermodesulfobacteria	1
CheC->CheC->?->SIG+TM(s)->SIG+TM->SIG+TM(s)->TM(s)->SIG+TM(s)*->SIG+APATPase->ParA-Soj-PloopNTPase->SIGMA-HTH->REC->	bacteria>proteobacteria>deltaproteobacteria	1
CheC->CheC->?->SIG+TM(s)->SIG+TM->SIG+TM(s)->TM(s)->SIG+TM(s)*->SIG+APATPase->ParA-Soj-PloopNTPase->SIGMA-HTH->REC->	bacteria>thermodesulfobacteria	1
CheC->CheC->?->SIG+TM(s)->SIG+TM->SIG+TM(s)->TM(s)->SIG+TM(s)*->SIG+APATPase->SIG+BetaPropeller-><-ABC-ATPase	bacteria>firmicutes	1
CheC->CheC-><-?<-?<-?<-?<-SIG+TM(s)<-SIG+TM(s)*<-SIG+TM<-IONCHANNEL<-?<-?<-?<-?<-SIG+BetaPropeller	bacteria>proteobacteria>alphaproteobacteria	1
CheC->CheC->Cluster617_2clades->SIG+TM(s)->SIG+TM->SIG+TM(s)->TM(s)->SIG+TM(s)*->SIG+APATPase->ParA-Soj-PloopNTPase->	bacteria>fcb group	1
CheC->CheC->PSE->SIG+TM->SIG+TM(s)->TM(s)->SIG+TM(s)*->	bacteria>proteobacteria>gammaproteobacteria	1
CheC->CheC->SIG+TM->SIG+TM(s)->SIG+TM->SIG+TM(s)->TM(s)->SIG+TM(s)*->	bacteria>proteobacteria>gammaproteobacteria	1
CheC->CheC->SIG+TM->SIG+TM(s)->SIG+TM->SIG+TM(s)->TM(s)->SIG+TM(s)*->?->?-><-?<-SIG+TM(s)<-SIG+TM(s)<-?<-LACI-HTH+PBPI	bacteria>actinobacteria	1
CheC->CheC->SIG+TM->SIG+TM(s)->SIG+TM->SIG+TM(s)->TM(s)->SIG+TM(s)*->?->?->SIGMA-HTH->	bacteria>actinobacteria	1
CheC->CheC->SIG+TM->SIG+TM(s)->SIG+TM->SIG+TM(s)->TM(s)->SIG+TM(s)*->SIG+APATPase->ParA-Soj-PloopNTPase->	bacteria>proteobacteria>gammaproteobacteria	1
CheC->CheC->SIG+TM->SIG+TM(s)->SIG+TM->SIG+TM(s)->TM(s)->SIG+TM(s)*->SIG+APATPase->ParA-Soj-PloopNTPase->?->SIGMA-HTH->?-><-Cluster775_2clades	bacteria>fcb group	1
CheC->CheC->SIG+TM->SIG+TM(s)->SIG+TM->SIG+TM(s)->TM(s)->SIG+TM(s)*->SIG+APATPase->ParA-Soj-PloopNTPase->PilZ->?->SIGMA-HTH->FilH->SIG+BetaPropeller->	bacteria>firmicutes	1
CheC->CheC->SIG+TM->SIG+TM(s)->SIG+TM->SIG+TM(s)->TM(s)->SIG+TM(s)*->SIG+APATPase->ParA-Soj-PloopNTPase->PilZ->CheC->CheD->?->SIGMA-HTH->	bacteria>firmicutes	1
CheC->CheC->SIG+TM->SIG+TM(s)->SIG+TM->SIG+TM(s)->TM(s)->SIG+TM(s)*->SIG+APATPase->ParA-Soj-PloopNTPase->PilZ->REC->HPT+HISKIN+CheW->CheW->CheC->	bacteria>firmicutes	1
CheC->CheC->SIG+TM->SIG+TM(s)->SIG+TM->SIG+TM(s)->TM(s)->SIG+TM(s)*->SIG+APATPase->ParA-Soj-PloopNTPase->SIGMA-HTH->?->?->HD->	bacteria>proteobacteria>gammaproteobacteria	1
CheC->CheC->SIG+TM->SIG+TM(s)->SIG+TM->SIG+TM(s)->TM(s)->SIG+TM(s)*->SIG+APATPase->ParA-Soj-PloopNTPase->SIGMA-HTH-><-SIGMA-HTH	bacteria>proteobacteria>deltaproteobacteria	1
CheC->CheC->SIG+TM->SIG+TM(s)->SIG+TM->SIG+TM(s)->TM(s)->SIG+TM(s)*->SIG+APATPase->ParA-Soj-PloopNTPase->SIGMA-HTH->REC->	bacteria>proteobacteria>gammaproteobacteria	1
CheC->CheC->SIG+TM->SIG+TM(s)->SIG+TM->SIG+TM(s)->TM(s)->SIG+TM(s)*->SIG+APATPase->ParA-Soj-PloopNTPase->SIGMA-HTH->REC->SFII-RAD3->	bacteria>proteobacteria>gammaproteobacteria	1
CheC->CheC->SIG+TM->SIG+TM(s)->SIG+TM->SIG+TM(s)->TM(s)->SIG+TM(s)*->SIG+APATPase->ParA-Soj-PloopNTPase->SIGMA-HTH->REC->SFII-RAD3->HPT+HISKIN+CheW->SIG+TM(s)->	bacteria>proteobacteria>gammaproteobacteria	1
CheC->CheC->SIG+TM->SIG+TM(s)->SIG+TM->SIG+TM(s)->TM(s)->SIG+TM(s)*->SIG+APATPase->ParA-Soj-PloopNTPase->SIGMA-HTH->REC->SFII-RAD3->PSE->REC->PSE->TM+OmpA->	bacteria>proteobacteria>gammaproteobacteria	1
CheC->CheC->SIG+TM->SIG+TM(s)->SIG+TM->SIG+TM(s)->TM(s)->SIG+TM(s)*->SIG+APATPase->ParA-Soj-PloopNTPase->SIGMA-HTH->REC->TM->	bacteria>proteobacteria>deltaproteobacteria	1
CheC->CheC->SIG+TM->SIG+TM(s)->SIG+TM->SIG+TM(s)->TM(s)->SIG+TM(s)*->SIG+APATPase->SIGMA-HTH->	bacteria>firmicutes	1
CheC->CheC->SIG+TM->SIG+TM(s)->SIG+TM->SIG+TM(s)->TM(s)->SIG+TM(s)*->SIG+APATPase->SIGMA-HTH->REC->SFII-RAD3->HPT+HISKIN+CheW->REC->SIG+TM(s)->	bacteria>proteobacteria>gammaproteobacteria	1
CheC->CheC->SIG+TM(s)->?->SIG+TM->SIG+TM(s)->TM(s)->SIG+TM(s)*->	bacteria>proteobacteria>gammaproteobacteria	1
CheC->CheC->SIG+TM(s)->SIG+TM-><-?||SIG+TM(s)->TM(s)->SIG+TM(s)*->	bacteria>proteobacteria>betaproteobacteria	1
CheC->CheC->SIG+TM(s)->SIG+TM->SIG+TM(s)->TM(s)->SIG+TM(s)*->?->?->HD+Tox-RelA+TGS->	bacteria>proteobacteria>gammaproteobacteria	1
CheC->CheC->SIG+TM(s)->SIG+TM->SIG+TM(s)->TM(s)->SIG+TM(s)*-><-?<-Cluster120_5clades<-?<-Cluster728_2clades	bacteria>proteobacteria>betaproteobacteria	1
CheC->CheC->SIG+TM(s)->SIG+TM->SIG+TM(s)->TM(s)->SIG+TM(s)*->Cluster255_4clades->	bacteria>proteobacteria>gammaproteobacteria	1
CheC->CheC->SIG+TM(s)->SIG+TM->SIG+TM(s)->TM(s)->SIG+TM(s)*->SIG+TarH+TM+HAMP+MA->	bacteria>proteobacteria>betaproteobacteria	1
CheC->REC->?->SIG+TM(s)->SIG+TM->SIG+TM(s)->TM(s)->SIG+TM(s)*->SIG+APATPase->ParA-Soj-PloopNTPase->PilZ->REC->HPT+HISKIN+CheW->CheC->CheD->	bacteria>synergistetes	1
CheC->REC->SIG+TM->SIG+TM(s)->SIG+TM->SIG+TM(s)->TM(s)->SIG+TM(s)*->PSE->ParA-Soj-PloopNTPase->REC->HPT+HISKIN+CheW->CheW->CheC->CheD->	bacteria>firmicutes	1
CheC->REC->SIG+TM->SIG+TM(s)->SIG+TM->SIG+TM(s)->TM(s)->SIG+TM(s)*->SIG+APATPase->	bacteria>firmicutes	1
CheC->REC->SIG+TM->SIG+TM(s)->SIG+TM->SIG+TM(s)->TM(s)->SIG+TM(s)*->SIG+APATPase->?->REC->CheC->CheD->SIGMA-HTH->	bacteria>firmicutes	1
CheC->REC->SIG+TM->SIG+TM(s)->SIG+TM->SIG+TM(s)->TM(s)->SIG+TM(s)*->SIG+APATPase->ParA-Soj-PloopNTPase->	bacteria>firmicutes	1
CheC->REC->SIG+TM->SIG+TM(s)->SIG+TM->SIG+TM(s)->TM(s)->SIG+TM(s)*->SIG+APATPase->ParA-Soj-PloopNTPase->?->HPT+HISKIN+CheW->CheW->CheC->CheD->	bacteria>firmicutes	1
CheC->REC->SIG+TM->SIG+TM(s)->SIG+TM->SIG+TM(s)->TM(s)->SIG+TM(s)*->SIG+APATPase->ParA-Soj-PloopNTPase->HPT+HISKIN+CheW->CheW->CheC->CheD->SIGMA-HTH->	bacteria>firmicutes	1
CheC->REC->SIG+TM->SIG+TM(s)->SIG+TM->SIG+TM(s)->TM(s)->SIG+TM(s)*->SIG+APATPase->ParA-Soj-PloopNTPase->PilZ->CheC->CheD->?->SIGMA-HTH->	bacteria>firmicutes	1
CheC->REC->SIG+TM->SIG+TM(s)->SIG+TM->SIG+TM(s)->TM(s)->SIG+TM(s)*->SIG+APATPase->ParA-Soj-PloopNTPase->PilZ->REC->HPT+HISKIN+CheW->	bacteria>firmicutes	1
CheC->REC->SIG+TM->SIG+TM(s)->SIG+TM->SIG+TM(s)->TM(s)->SIG+TM(s)*->SIG+APATPase->ParA-Soj-PloopNTPase->REC->CheW->CheC->CheD->SIGMA-HTH->	bacteria>firmicutes	1
CheC->REC->SIG+TM->SIG+TM(s)->SIG+TM->SIG+TM(s)->TM(s)->SIG+TM(s)*->SIG+APATPase->ParA-Soj-PloopNTPase->REC->HPT+HISKIN+CheW->	bacteria>firmicutes	1
CheC->REC->SIG+TM->SIG+TM(s)->SIG+TM->SIG+TM(s)->TM(s)->SIG+TM(s)*->SIG+APATPase->ParA-Soj-PloopNTPase->REC->HPT+HISKIN+CheW->CheW->CheD->	bacteria>firmicutes	1
CheC->REC->SIG+TM->SIG+TM(s)->SIG+TM->SIG+TM(s)->TM(s)->SIG+TM(s)*->SIG+APATPase->ParA-Soj-PloopNTPase->REC->HPT+HISKIN+CheW->CheW->CheD->SIGMA-HTH->	bacteria>firmicutes	1
CheC->SIG+BetaPropeller->SIG+BetaPropeller->?->TM->Cluster112_5clades->Cluster309_2clades->SIG+TM(s)*->SIG+APATPase->ParA-Soj-PloopNTPase->SIGMA-HTH->?->SIG+TPR->Cluster115_5clades->DOUBLECORTIN->	bacteria>aquificae	1
CheC->SIG+BetaPropeller->SIG+BetaPropeller->SIG+SAF->TM->Cluster112_5clades->Cluster309_2clades->SIG+TM(s)*->SIG+APATPase->ParA-Soj-PloopNTPase->SIGMA-HTH->?->SIG+TPR->Cluster115_5clades->DOUBLECORTIN->	bacteria>aquificae	1
CheC->SIG+TM->SIG+TM(s)->SIG+TM->SIG+TM(s)->TM(s)->?->SIG+TM(s)*->SIG+APATPase->ParA-Soj-PloopNTPase->SIGMA-HTH->REC->SFII-RAD3->HPT+HISKIN+CheW->	bacteria>proteobacteria>gammaproteobacteria	1
CheC->SIG+TM->SIG+TM(s)->SIG+TM->SIG+TM(s)->TM(s)->?->SIG+TM(s)*->SIG+APATPase->ParA-Soj-PloopNTPase->SIGMA-HTH->REC->SFII-RAD3->HPT+HISKIN+CheW->REC->	bacteria>proteobacteria>gammaproteobacteria	1
CheC->SIG+TM->SIG+TM(s)->SIG+TM->SIG+TM(s)->TM(s)->SIG+TM(s)*->?->SIGMA-HTH-><-REC	bacteria>other unclassified bacteria	1
CheC->SIG+TM->SIG+TM(s)->SIG+TM->SIG+TM(s)->TM(s)->SIG+TM(s)*->SIG+APATPase->ParA-Soj-PloopNTPase->?-><-?||SIGMA-HTH->FilH->	bacteria>spirochaetes	1
CheC->SIG+TM->SIG+TM(s)->SIG+TM->SIG+TM(s)->TM(s)->SIG+TM(s)*->SIG+APATPase->ParA-Soj-PloopNTPase->SIGMA-HTH->REC->SFII-RAD3->HPT+HISKIN+CheW->REC->	bacteria>proteobacteria>gammaproteobacteria	1
CheC->SIG+TM(s)->SIG+TM(s)*->	bacteria>pvc group	1
CheD->HD->?->SIG+PTSEIIA1->SIG+TM(s)->TM(s)->SIG+TM(s)*->SIG+APATPase->ParA-Soj-PloopNTPase->SIGMA-HTH->REC->TM->	bacteria>proteobacteria>deltaproteobacteria	1
CheD->REC->REC->SFII-RAD3-><-SIG+TIMbarrel||MODE-HTH+PBPII->TM(s)->SIG+TM(s)*->SIG+APATPase->ParA-Soj-PloopNTPase->SIGMA-HTH-><-DICT<-Cluster40_2clades<-SIG+SAF	bacteria>proteobacteria>betaproteobacteria	1
CheRN-Alpha+CheR-Methylase->CheD->REC->REC->SFII-RAD3-><-?||TM(s)->SIG+TM(s)*->SIG+APATPase->ParA-Soj-PloopNTPase->SIGMA-HTH->	bacteria>proteobacteria>betaproteobacteria	1
CheRN-Alpha+CheR-Methylase->PSE->REC->SFII-RAD3->PSE->SIG+TM(s)*->SIG+TM->	bacteria>proteobacteria>gammaproteobacteria	1
CheRN-Alpha+CheR-Methylase->REC->REC->SFII-RAD3->TM(s)->SIG+TM(s)*->SIG+APATPase-><-DICT<-Cluster40_2clades	bacteria>proteobacteria>betaproteobacteria	1
CheW->?->CheRN-Alpha+CheR-Methylase->CheD->REC->REC->?-><-SIG+TM(s)*<-TM(s)<-SIG+TM(s)<-SIG+TM<-SIG+TM(s)<-CheC<-CheC	bacteria>proteobacteria>betaproteobacteria	1
CheW->REC->?->SIG+TM(s)->SIG+TM->SIG+TM(s)->TM(s)->SIG+TM(s)*->	bacteria>thermotogae	1
CheW->REC->?->SIG+TM(s)->SIG+TM->SIG+TM(s)->TM(s)->SIG+TM(s)*->SIG+APATPase->ParA-Soj-PloopNTPase->?->CheC->CheD->	bacteria>thermotogae	1
CheW->REC->?->SIG+TM(s)->SIG+TM->SIG+TM(s)->TM(s)->SIG+TM(s)*->SIG+APATPase->ParA-Soj-PloopNTPase->PilZ->CheC->	bacteria>thermotogae	1
CheW->SIG+TarH+TM+HAMP+MA->CheRN-Alpha+CheR-Methylase->REC->REC->SFII-RAD3->TM(s)->SIG+TM(s)*->SIG+APATPase->Cluster216_2clades->SIG+TM->SIGMA-HTH-><-ABC-ATPase(s)	bacteria>proteobacteria>betaproteobacteria	1
ClpABN-AAA+SLATT+ClpABC-AAA-><-?<-?<-?<-PspC(s)+LiaI-LiaF-TM+Toast-rack*<-PADR-HTH	bacteria>fcb group	1
Cluster115_5clades->DOUBLECORTIN->?->SIG+TM->SIG+TM(s)*->SIG+TM(s)->TM(s)->	bacteria>proteobacteria>alphaproteobacteria	1
Cluster120_5clades->?-><-SIGMA-HTH<-ParA-Soj-PloopNTPase<-SIG+APATPase<-SIG+TM(s)*<-?<-?<-?<-SIG+SAF	bacteria>proteobacteria>alphaproteobacteria	1
Cluster120_5clades->?-><-SIGMA-HTH<-SIG+TM(s)*	bacteria>proteobacteria>alphaproteobacteria	1
Cluster120_5clades-><-SIG+TM(s)*<-TM(s)<-SIG+TM(s)<-SIG+TM<-SIG+TM(s)<-CheC<-CheC	bacteria>proteobacteria>betaproteobacteria	1
Cluster133_3clades->?->SIG+TM(s)->SIG+TM->SIG+TM(s)->TM(s)->SIG+TM(s)*->NACHT->	bacteria>proteobacteria>betaproteobacteria	1
Cluster193_7clades->?->?->?->?->?->SIG+TM(s)*->SIG+APATPase->ParA-Soj-PloopNTPase->SIGMA-HTH->	bacteria>proteobacteria>gammaproteobacteria	1
Cluster193_7clades->Cluster716_2clades-><-?<-?<-ABC-ATPase<-?<-?*<-PspC	bacteria>thermotogae	1
Cluster193_7clades->LiaI-LiaF-TM+Toast-rack*->?-><-?<-?<-SIGMA-HTH	bacteria>other unclassified bacteria	1
Cluster251_2clades->FHA+TM->Cluster172_2clades->TPR->SIG+TM(s)*->TM->Cluster154_3clades->	bacteria>proteobacteria>gammaproteobacteria	1
Cluster251_2clades->FHA+TM->Cluster172_2clades->TPR->SIG+TM(s)*->TM->Cluster154_3clades-><-SIG+TPR||Cluster301_2clades->?->?->SIG+TM->	bacteria>proteobacteria>gammaproteobacteria	1
Cluster253_2clades->?->?->ABC-ATPase->?->?->?->LiaI-LiaF-TM*->	bacteria>firmicutes	1
Cluster253_2clades->?->?*->	bacteria>firmicutes	1
Cluster253_2clades->?*->?->?->SIG+NtrC-AAA+FIS-HTH->	bacteria>other unclassified bacteria	1
Cluster263_2clades->SIG+TM(s)*->	bacteria>others	1
Cluster263_2clades->SIG+TM(s)*->Cluster638_2clades->	bacteria>others	1
Cluster27_3clades->PYRIN->SIG+TM(s)*->Cluster49_2clades->NACHT->Cluster59_2clades->?->Cluster24_2clades->SIG+TM(s)->SIG+TM->	bacteria>proteobacteria>gammaproteobacteria	1
Cluster306_3clades-><-?<-?||?->?->?-><-?*<-PADR-HTH	bacteria>fcb group	1
Cluster306_3clades-><-LiaI-LiaF-TM+Toast-rack+EP1*<-TM+LiaI-LiaF-TM*<-?<-SIGMA-HTH	bacteria>acidobacteria	1
Cluster354_2clades->?->?-><-?<-REC<-SIG+TM(s)<-?<-LiaI-LiaF-TM+Toast-rack*	bacteria>fcb group	1
Cluster366_2clades->SIG+TM(s)->TM+OmpA->?->?->?->TM(s)->SIG+TM(s)*->SIG+TM->	bacteria>proteobacteria>gammaproteobacteria	1
Cluster40_2clades->?-><-SIG+TM<-SIG+TM(s)*<-TM(s)	bacteria>proteobacteria>gammaproteobacteria	1
Cluster40_2clades->DICT-><-?<-SIGMA-HTH<-ParA-Soj-PloopNTPase<-SIG+APATPase<-SIG+TM(s)*	bacteria>proteobacteria>betaproteobacteria	1
Cluster40_2clades->DICT-><-SIG+APATPase<-SIG+TM(s)*<-TM(s)	bacteria>proteobacteria>betaproteobacteria	1
Cluster40_2clades->DICT-><-SIG+TM<-SIG+TM(s)*	bacteria>proteobacteria>gammaproteobacteria	1
Cluster40_2clades->DICT-><-SIG+TM<-SIG+TM(s)*<-TM(s)	bacteria>proteobacteria>gammaproteobacteria	1
Cluster40_2clades->DICT-><-TM+OmpA<-SIG+TM(s)<-SIGMA-HTH<-ParA-Soj-PloopNTPase<-SIG+APATPase<-SIG+TM(s)*	bacteria>proteobacteria>betaproteobacteria	1
Cluster408_2clades->?-><-TM+OmpA<-SIG+TM(s)<-SIGMA-HTH<-ParA-Soj-PloopNTPase<-SIG+APATPase<-SIG+TM(s)*<-TM(s)	bacteria>proteobacteria>betaproteobacteria	1
Cluster408_2clades-><-TM+OmpA<-SIG+TM(s)<-SIGMA-HTH<-ParA-Soj-PloopNTPase<-SIG+APATPase<-SIG+TM(s)*<-TM(s)<-?<-PSYN<-tRNA<-TRAM+METHYLASE	bacteria>proteobacteria>betaproteobacteria	1
Cluster420_2clades->Cluster307_3clades->?-><-SIG+TM<-SIG+TM(s)*<-TM(s)<-SFII-RAD3<-REC<-REC<-CheRN-Alpha+CheR-Methylase	bacteria>proteobacteria>gammaproteobacteria	1
Cluster422_2clades->?->?-><-?||?-><-SIGMA-HTH<-SIG+TM(s)*	bacteria>proteobacteria>alphaproteobacteria	1
Cluster422_2clades->?->?-><-?<-TIMbarrel<-SIGMA-HTH<-?<-SIG+TM(s)*	bacteria>proteobacteria>alphaproteobacteria	1
Cluster446_2clades->?-><-Cluster752_2clades||?-><-?<-?<-LiaI-LiaF-TM+Toast-rack*	bacteria>firmicutes	1
Cluster482_2clades->PSYN->?->?->?->?->TM(s)->SIG+TM(s)*->	bacteria>pvc group	1
Cluster485_2clades->Cluster366_2clades->?->SIG+TM(s)->TM+OmpA->TM(s)->SIG+TM(s)*->SIG+APATPase->ParA-Soj-PloopNTPase->SIGMA-HTH->SIG+TM(s)->	bacteria>proteobacteria>betaproteobacteria	1
Cluster485_2clades->Cluster366_2clades->SIG+TM(s)->TM+OmpA->TM(s)->SIG+TM(s)*-><-DICT<-SIG+SAF	bacteria>proteobacteria>gammaproteobacteria	1
Cluster511_3clades-><-?<-SIG+TM(s)*<-TM(s)<-SIG+TM(s)<-SIG+TM<-SIG+TM(s)<-SIG+TM<-CheC<-CheC	bacteria>actinobacteria	1
Cluster511_3clades-><-SIG+TM(s)<-SIGMA-HTH<-ParA-Soj-PloopNTPase<-SIG+APATPase<-SIG+TM(s)*<-TM(s)||Thymidylate-synthase->Cluster372_2clades->Cluster775_2clades->	bacteria>proteobacteria>betaproteobacteria	1
Cluster525_2clades->?->?-><-?<-?<-?<-?||SIG+TM(s)*->SIG+APATPase->ParA-Soj-PloopNTPase->?->SIG+TM(s)-><-DYN-MID-AAA	bacteria>aquificae	1
Cluster525_2clades->?->?->SIG+TM(s)*->SIG+TM(s)->TM(s)->?-><-?<-ParA-Soj-PloopNTPase<-?<-Cluster675_2clades	bacteria>proteobacteria>alphaproteobacteria	1
Cluster558_3clades->MORC->?->DYN-MID-AAA->?->?*->	bacteria>fcb group	1
Cluster57_2clades->SIG+TM(s)*->NACHT->TET-TPase->	bacteria>proteobacteria>gammaproteobacteria	1
Cluster57_2clades->SIG+TM(s)*->NACHT->TET-TPase->Cluster179_2clades->Cluster103_2clades->	bacteria>proteobacteria>gammaproteobacteria	1
Cluster57_2clades->SIG+TM(s)*->NACHT->TET-TPase->Cluster179_2clades->Cluster103_2clades->SIG+TM(s)->SIG+TM->SIG+TM(s)->	bacteria>proteobacteria>betaproteobacteria	1
Cluster588_2clades->Cluster440_3clades-><-?<-?<-ParA-Soj-PloopNTPase<-SIG+APATPase<-SIG+TM(s)*<-CheC<-?<-CheC<-SIG+TM	bacteria>proteobacteria>alphaproteobacteria	1
Cluster699_2clades-><-?<-TM+OmpA||SIG+TM(s)*->	bacteria>proteobacteria>gammaproteobacteria	1
Cluster699_2clades-><-Cluster426_2clades<-?<-?<-?<-?<-SIG+TM(s)*	bacteria>proteobacteria>epsilonproteobacteria	1
Cluster716_2clades-><-?||?->?*->	bacteria>actinobacteria	1
Cluster728_2clades->LiaI-LiaF-TM+Toast-rack*->	bacteria>other unclassified bacteria	1
Cluster752_2clades->?-><-Cluster542_3clades||SIG+TM->LiaI-LiaF-TM+Toast-rack*->	bacteria>actinobacteria	1
Cluster768_2clades->?->?->?-><-?||?-><-?||SIG+TM*->?->LiaI-LiaF-TM+Toast-rack*->?->REC->	bacteria>firmicutes	1
Cluster813_2clades-><-?*	bacteria>firmicutes	1
Cluster813_2clades-><-SIG+TM(s)||Cluster528_2clades->?-><-?||?->?->SIG+TM(s)*-><-?||?->?->Cluster538_3clades->?->?-><-RADICAL-SAM	bacteria>proteobacteria>epsilonproteobacteria	1
Cluster820_2clades->SIG+TM(s)*->SIG+APATPase->ParA-Soj-PloopNTPase->	bacteria>proteobacteria>deltaproteobacteria	1
Cluster865_2clades->?-><-?*<-?<-?<-?<-SIG+Phytase-like	bacteria>proteobacteria>gammaproteobacteria	1
Cluster893_2clades->?->?->Cluster108_2clades->?->?->TM(s)->SIG+TM(s)*->SIG+APATPase->ParA-Soj-PloopNTPase->SIGMA-HTH->SIG+TM(s)->TM+OmpA-><-DICT<-Cluster40_2clades	bacteria>proteobacteria>betaproteobacteria	1
Cluster949_2clades->?->SIG+TM(s)*-><-?<-?<-SIG+TarH+TM+HAMP+MA	bacteria>pvc group	1
CR-ATPase7->?->?->TPR->SIG+TM(s)*->	bacteria>proteobacteria>betaproteobacteria	1
CR-ATPase7->?->CR-REase10->?->TPR->SIG+TM(s)*->	bacteria>proteobacteria>gammaproteobacteria	1
CR-ATPase7->CR-REase10->?->TPR->SIG+TM(s)*->	bacteria>proteobacteria>deltaproteobacteria	1
CR-ATPase7->CR-REase10->?->TPR->SIG+TM(s)*->?->?->?->TPR->	bacteria>proteobacteria>gammaproteobacteria	1
CR-ATPase7->SIG+TM(s)*->	bacteria>proteobacteria>gammaproteobacteria	1
CR-ATPase7->SIG+TM(s)*->FHA->NACHT->TET-TPase->?->Cluster63_2clades->SIG+TM(s)->PSE->SIG+TM(s)->	bacteria>proteobacteria>gammaproteobacteria	1
CR-REase10->?->TPR->SIG+TM(s)*->	bacteria>pvc group	1
DICT-><-PSE<-SIGMA-HTH<-ParA-Soj-PloopNTPase<-SIG+APATPase<-SIG+TM(s)*<-TM(s)	bacteria>proteobacteria>betaproteobacteria	1
DOUBLECORTIN->CheC->SIG+TM->SIG+TM(s)->SIG+TM->SIG+TM(s)->TM(s)->SIG+TM(s)*->SIGMA-HTH->SIG+BetaPropeller->SIG+BetaPropeller->CheC->CheD->	bacteria>firmicutes	1
DOUBLECORTIN->SIG+Lysozyme->?->?->?->Cluster263_2clades->SIG+TM(s)*->NACHT->	bacteria>others	1
EMAP->?->REC->?->?->SIG+TM(s)*->SIG+APATPase->ParA-Soj-PloopNTPase->?->SIGMA-HTH->REC->CheC->CheC->	bacteria>deferribacteres	1
ENOYCOADEHYD-><-FURR-HTH<-?<-SIG+TM(s)||?->SIG+TM(s)*->SIG+APATPase->ParA-Soj-PloopNTPase->SIGMA-HTH->	bacteria>aquificae	1
FHA+TM->?->TPR->SIG+TM(s)*->REC->TM->	bacteria>proteobacteria>alphaproteobacteria	1
FHA+TM->?->TPR->SIG+TM(s)*->REC->TM->?-><-SIG+TPR	bacteria>proteobacteria>alphaproteobacteria	1
FHA+TM->?->TPR->SIG+TM(s)*->TM->Cluster154_3clades-><-SIG+TPR||Cluster301_2clades->?->?->SIG+TM->	bacteria>proteobacteria>gammaproteobacteria	1
FHA+TM->Cluster172_2clades->TPR->SIG+TM(s)*->TM->Cluster154_3clades-><-SIG+TPR	bacteria>proteobacteria>gammaproteobacteria	1
FHA+TM->Cluster172_2clades->TPR->SIG+TM(s)*->TM->Cluster154_3clades-><-SIG+TPR||Cluster301_2clades->?->?->SIG+TM->	bacteria>proteobacteria>gammaproteobacteria	1
FHA+TM->SIG+TM(s)*->?->TM->	bacteria>proteobacteria>alphaproteobacteria	1
FormylT-><-?<-REC<-SIG+TM(s)<-LiaI-LiaF-TM+Toast-rack*	bacteria>fcb group	1
HPT+HISKIN+CheW->CheW->?->CheRN-Alpha+CheR-Methylase->CheD->REC->REC-><-SIG+TM(s)*<-TM(s)<-SIG+TM(s)<-SIG+TM<-SIG+TM(s)<-CheC<-CheC	bacteria>proteobacteria>betaproteobacteria	1
IONCHANNEL->SIG+TM->?->SIG+TM(s)*->?->SIG+TM(s)->	bacteria>proteobacteria>alphaproteobacteria	1
IONCHANNEL->SIG+TM->?->SIG+TM(s)*->SIG+TM(s)->	bacteria>proteobacteria>alphaproteobacteria	1
IONCHANNEL->SIG+TM->CheC->?->CheC->SIG+TM(s)*->?->?->?->?->Cluster255_4clades->	bacteria>proteobacteria>alphaproteobacteria	1
IONCHANNEL->SIG+TM->SIG+TM(s)*->	bacteria>proteobacteria>alphaproteobacteria	1
ISOCOT->ParA-Soj-PloopNTPase->?->LiaI-LiaF-TM+Toast-rack*->	bacteria>firmicutes	1
LiaI-LiaF-TM*->?->?->?->?->Thymidylate-synthase->?->Cluster372_2clades->	bacteria>other unclassified bacteria	1
LiaI-LiaF-TM*->?->?->LiaI-LiaF-TM+Toast-rack*->PSE->REC->	bacteria>firmicutes	1
LiaI-LiaF-TM*->?->PspC->?->?->REC->	bacteria>firmicutes	1
LiaI-LiaF-TM*->LiaI-LiaF-TM+Toast-rack*->SIG+TM(s)->REC->	bacteria>proteobacteria>betaproteobacteria	1
LiaI-LiaF-TM+Toast-rack*->	archaea>euryarchaeota	1
LiaI-LiaF-TM+Toast-rack*->	bacteria>actinobacteria	1
LiaI-LiaF-TM+Toast-rack*->?->SIG+TM(s)->REC->?->?->Cluster638_2clades->	bacteria>fcb group	1
LiaI-LiaF-TM+Toast-rack*-><-?<-?||TIMbarrel->TIMbarrel->	bacteria>firmicutes	1
LiaI-LiaF-TM+Toast-rack*-><-?<-?<-Cluster542_3clades	bacteria>fcb group	1
LiaI-LiaF-TM+Toast-rack*-><-ABC-ATPase	bacteria>firmicutes	1
LiaI-LiaF-TM+Toast-rack*-><-TM(s)	bacteria>proteobacteria>betaproteobacteria	1
LiaI-LiaF-TM+Toast-rack*->ABC-ATPase->	bacteria>chloroflexi	1
LiaI-LiaF-TM+Toast-rack*->EMAP->	archaea>euryarchaeota	1
LiaI-LiaF-TM+Toast-rack*->SIG+TM(s)->?->REC-><-Cluster675_2clades	bacteria>proteobacteria>gammaproteobacteria	1
LiaI-LiaF-TM+Toast-rack*->SIG+TM(s)-><-REC	bacteria>acidobacteria	1
LiaI-LiaF-TM+Toast-rack*->SIG+TM(s)->REC->	bacteria>proteobacteria>gammaproteobacteria	1
MORC-><-SIG+TM(s)*<-TM(s)<-SIG+TM(s)<-SIG+TM<-SIG+TM(s)<-CheC<-CheC	bacteria>proteobacteria>gammaproteobacteria	1
MORC->Cluster408_2clades->Cluster820_2clades->?->?->?->?-><-LiaI-LiaF-TM+Toast-rack*	bacteria>fcb group	1
NACHT->?->?->?->?->Cluster814_2clades->?-><-?*	bacteria>chloroflexi	1
O6MGT-HTH->?->PspC->?*->?->?->?->HMA+TM(s)->	bacteria>other unclassified bacteria	1
O6MGT-HTH-><-LiaI-LiaF-TM+Toast-rack*<-PspC	bacteria>fcb group	1
O6MGT-HTH-><-LiaI-LiaF-TM+Toast-rack*<-PspC||?->?->?->?->DHH->	bacteria>fcb group	1
PADR-HTH->?*->	bacteria>other unclassified bacteria	1
PADR-HTH->DUF1700-alpha-helical+PspC(s)+LiaI-LiaF-TM+Toast-rack*-><-?<-SIGMA-HTH	bacteria>fcb group	1
PADR-HTH->PspC(s)+LiaI-LiaF-TM+Toast-rack(s)*->?->?->?->?->?->?->Cluster192_2clades->	bacteria>fcb group	1
PADR-HTH->PspC(s)+LiaI-LiaF-TM+Toast-rack(s)*-><-?||?->?->?-><-REC<-SIG+TM(s)<-LiaI-LiaF-TM+Toast-rack*	bacteria>fcb group	1
PADR-HTH->PspC(s)+LiaI-LiaF-TM+Toast-rack(s)*-><-?<-?<-?||?->Cluster893_2clades->	bacteria>fcb group	1
PADR-HTH->PspC+LiaI-LiaF-TM+Toast-rack*->?->?-><-SIG+PEP-utilisers-C	bacteria>fcb group	1
PIN+APATPase-><-?<-?<-?<-SIG+TM(s)*<-?<-TM(s)<-SIG+TM(s)<-SIG+TM<-SIG+TM(s)<-SIG+TM<-CheC	bacteria>actinobacteria	1
PIN+APATPase-><-?<-?<-SIG+TM(s)*	bacteria>actinobacteria	1
PspC->?->LiaI-LiaF-TM+Toast-rack*->	bacteria>fcb group	1
PspC->?*->	bacteria>fcb group	1
PspC->?*->	bacteria>other unclassified bacteria	1
PspC->?*->?-><-Cluster709_2clades	bacteria>other unclassified bacteria	1
PspC->?*-><-Cluster673_2clades<-?<-?||ISOCOT->	bacteria>chloroflexi	1
PspC->LiaI-LiaF-TM+Toast-rack*->	bacteria>fcb group	1
PspC->LiaI-LiaF-TM+Toast-rack*->	bacteria>other unclassified bacteria	1
PspC->PSE->?*->	bacteria>fcb group	1
PspC->PspC->LiaI-LiaF-TM+Toast-rack*->	bacteria>fcb group	1
PspC+LiaI-LiaF-TM*->	bacteria>fcb group	1
PSYN->?->TM(s)->SIG+TM(s)*->	bacteria>proteobacteria>betaproteobacteria	1
PSYN->?->TM(s)->SIG+TM(s)*->?->SIG+APATPase->ParA-Soj-PloopNTPase->SIGMA-HTH->SIG+TM(s)->TM+OmpA-><-DICT	bacteria>proteobacteria>betaproteobacteria	1
PYRIN->SIG+TM(s)*->Cluster49_2clades->NACHT->?->?->Cluster24_2clades->SIG+TM(s)->SIG+TM->	bacteria>proteobacteria>betaproteobacteria	1
PYRIN->SIG+TM(s)*->NACHT->Cluster59_2clades->?->Cluster24_2clades->SIG+TM(s)->SIG+TM->SIG+TM(s)->	bacteria>proteobacteria>betaproteobacteria	1
REC-><-?<-SIG+TM(s)*	bacteria>proteobacteria>epsilonproteobacteria	1
REC-><-SIG+TM(s)*	bacteria>armatimonadetes	1
REC-><-SIG+TM(s)*<-SIG+NtrC-AAA+FIS-HTH<-SIG+TM(s)<-CheC	bacteria>proteobacteria>alphaproteobacteria	1
REC->SFII-RAD3->HPT+HISKIN+CheW->?->CheRN-Alpha+CheR-Methylase->REC->TM(s)->SIG+TM(s)*->SIG+APATPase->ParA-Soj-PloopNTPase->SIGMA-HTH->SIG+TM(s)->TM+OmpA-><-DICT<-Cluster40_2clades	bacteria>proteobacteria>betaproteobacteria	1
REC->SIG+TM->SIG+TM(s)->SIG+TM-><-?||SIG+TM(s)->TM(s)->SIG+TM(s)*->SIG+APATPase->ParA-Soj-PloopNTPase->REC->HPT+HISKIN+CheW->CheW->	bacteria>firmicutes	1
REC->SIG+TM->SIG+TM(s)->SIG+TM->SIG+TM(s)->TM(s)->SIG+TM(s)*->?->?->?->?->Cluster120_5clades->Cluster120_5clades->Cluster120_5clades->	bacteria>actinobacteria	1
REC->SIG+TM->SIG+TM(s)->SIG+TM->SIG+TM(s)->TM(s)->SIG+TM(s)*->SIG+APATPase->ParA-Soj-PloopNTPase->REC->HPT+HISKIN+CheW->CheW->CheC->CheD->	bacteria>firmicutes	1
SIG+ACET->SIG+TM(s)->TM(s)-><-TET-TPase<-NACHT<-?<-SIG+TM(s)*<-?<-Cluster27_3clades	bacteria>proteobacteria>betaproteobacteria	1
SIG+BetaPropeller->?->?->?->?->IONCHANNEL->SIG+TM->SIG+TM(s)*->SIG+TM(s)->?->?->?->?-><-?||MODE-HTH+PBPII->	bacteria>proteobacteria>alphaproteobacteria	1
SIG+BetaPropeller->CheC->?->SIG+TM(s)->SIG+TM->SIG+TM(s)->TM(s)->SIG+TM(s)*->SIG+APATPase->SIGMA-HTH->CheC->	bacteria>acidobacteria	1
SIG+BetaPropeller->SIG+BetaPropeller->SIG+SAF->TM->?-><-TM(s)<-SIG+TM(s)<-SIG+TM(s)*<-?<-?<-SIG+TM(s)<-?<-?<-TM||SIG+TM->	bacteria>proteobacteria>alphaproteobacteria	1
SIG+BetaPropeller->SIG+SAF->TM->?-><-?<-TM(s)<-SIG+TM(s)<-SIG+TM(s)*<-?<-?<-?<-SIG+TM(s)<-?<-?<-TM	bacteria>proteobacteria>alphaproteobacteria	1
SIG+BetaPropeller->SIG+SAF->TM->?-><-?<-TM(s)<-SIG+TM(s)<-SIG+TM(s)*<-?<-?<-Cluster525_2clades	bacteria>proteobacteria>alphaproteobacteria	1
SIG+BetaPropeller->SIG+SAF->TM->?-><-?<-TM(s)<-SIG+TM(s)<-SIG+TM(s)*<-?<-?<-SIG+TM(s)<-?<-?<-TM||SIG+TM->	bacteria>proteobacteria>alphaproteobacteria	1
SIG+BetaPropeller->SIG+SAF->TM->?-><-?<-TM(s)<-SIG+TM(s)<-SIG+TM(s)*<-?<-SIG+TM(s)<-?<-?<-TM||SIG+TM->	bacteria>proteobacteria>alphaproteobacteria	1
SIG+CARDB->?->?->?-><-DUF1700-alpha-helical+PspC+LiaI-LiaF-TM*<-PADR-HTH	bacteria>other unclassified bacteria	1
SIG+CARDB->?->SIG+TM(s)*->SIG+APATPase->	bacteria>proteobacteria>gammaproteobacteria	1
SIG+IF2-HTH+sGTP->Cluster482_2clades->DHH->PSYN->Cluster294_3clades->?->PspC->?*->	bacteria>firmicutes	1
SIG+LiaI-LiaF-TM*->	bacteria>actinobacteria	1
SIG+Lysozyme->?->?->?->Cluster263_2clades->SIG+TM(s)*->NACHT->	bacteria>others	1
SIG+Lysozyme->SIG+TM(s)*->Cluster27_3clades->?->Cluster623_2clades->?->SIG+TM->?->Cluster133_3clades->	bacteria>proteobacteria>alphaproteobacteria	1
SIG+MHYT+TM(s)+GGDEF+EAL->?->TM(s)->SIG+TM(s)*->	bacteria>proteobacteria>gammaproteobacteria	1
SIG+MHYT+TM(s)+GGDEF+EAL-><-?<-SIGMA-HTH<-SIG+TM(s)*	bacteria>proteobacteria>alphaproteobacteria	1
SIG+MHYT+TM(s)+GGDEF+EAL->TM(s)->SIG+TM(s)*->SIG+APATPase->ParA-Soj-PloopNTPase->SIGMA-HTH->REC->SFII-RAD3->HPT+HISKIN+CheW->SIG+TM(s)->	bacteria>proteobacteria>gammaproteobacteria	1
SIG+NtrC-AAA+FIS-HTH->?->?->?->?->PADR-HTH->?*-><-?<-?||?->TetR-HTH->	bacteria>fcb group	1
SIG+NtrC-AAA+FIS-HTH->SIG+TM(s)*->SIG+APATPase-><-?<-?<-ABC-ATPase	bacteria>proteobacteria>alphaproteobacteria	1
SIG+PEP-utilisers-C->?->?-><-?||?->?-><-?*<-?<-?*<-?<-SIGMA-HTH	bacteria>acidobacteria	1
SIG+PTSEIIA1-><-?<-?<-Cluster891_2clades<-?<-ParA-Soj-PloopNTPase<-SIG+APATPase<-SIG+TM(s)*||?->?->TRAM+METHYLASE->?->?->ABC-ATPase->	bacteria>aquificae	1
SIG+PTSEIIA1->SIG+TM(s)->TM(s)->SIG+TM(s)*->SIG+APATPase->ParA-Soj-PloopNTPase->SIGMA-HTH->REC->TM->	bacteria>proteobacteria>deltaproteobacteria	1
SIG+SAF->?->?-><-SIGMA-HTH<-?<-SIG+APATPase<-SIG+TM(s)*	bacteria>proteobacteria>betaproteobacteria	1
SIG+SAF->?->Cluster40_2clades->DICT-><-SIG+TM<-SIG+TM(s)*<-TM(s)	bacteria>proteobacteria>gammaproteobacteria	1
SIG+SAF->Cluster40_2clades->?-><-SIGMA-HTH<-?<-SIG+APATPase<-SIG+TM(s)*<-TM(s)	bacteria>proteobacteria>betaproteobacteria	1
SIG+SAF->Cluster40_2clades->?-><-SIGMA-HTH<-?<-SIG+APATPase<-SIG+TM(s)*<-TM(s)<-SFII-RAD3<-REC<-TM+OmpA<-SIG+TM(s)	bacteria>proteobacteria>betaproteobacteria	1
SIG+SAF->Cluster40_2clades-><-SIG+APATPase<-Cluster255_4clades<-SIG+TM(s)*<-TM(s)	bacteria>proteobacteria>betaproteobacteria	1
SIG+SAF->Cluster40_2clades->DICT-><-SIG+APATPase<-SIG+TM(s)*<-TM(s)<-SFII-RAD3<-REC<-REC<-CheRN-Alpha+CheR-Methylase<-SIG+TarH+TM+HAMP+MA<-CheW	bacteria>proteobacteria>betaproteobacteria	1
SIG+SAF->Cluster40_2clades->DICT-><-SIG+TM<-SIG+TM(s)*	bacteria>proteobacteria>gammaproteobacteria	1
SIG+SAF->Cluster40_2clades->DICT-><-SIGMA-HTH<-ParA-Soj-PloopNTPase<-SIG+APATPase<-SIG+TM(s)*<-TM(s)<-SFII-RAD3<-REC<-REC<-CheD<-CheRN-Alpha+CheR-Methylase	bacteria>proteobacteria>betaproteobacteria	1
SIG+SAF->TM->Cluster112_5clades->Cluster309_2clades->SIG+TM(s)*->SIG+APATPase->ParA-Soj-PloopNTPase->SIGMA-HTH->?->SIG+TPR->Cluster115_5clades->DOUBLECORTIN->	bacteria>proteobacteria>epsilonproteobacteria	1
SIG+SHELIX+GGDEF->TM(s)->SIG+TM(s)*->	bacteria>proteobacteria>gammaproteobacteria	1
SIG+TarH+TM+HAMP+MA->CheRN-Alpha+CheR-Methylase->REC->REC->SFII-RAD3->?->TM(s)->PSE->SIG+TM(s)*-><-CHTH<-HIN-HTH||SIG+TM(s)*->SIG+APATPase-><-DICT<-Cluster40_2clades||HIN-HTH->CHTH-><-SIG+SAF	bacteria>proteobacteria>betaproteobacteria	1
SIG+TarH+TM+HAMP+MA->CheRN-Alpha+CheR-Methylase->REC->REC->SFII-RAD3-><-?||TM(s)->SIG+TM(s)*->SIG+TM->	bacteria>proteobacteria>gammaproteobacteria	1
SIG+TarH+TM+HAMP+MA->CheRN-Alpha+CheR-Methylase->REC->SIG+TarH+TM+HAMP+MA->REC->SFII-RAD3->TM(s)->SIG+TM(s)*->SIG+APATPase->Cluster216_2clades->SIG+TM->SIGMA-HTH->SIG+TM(s)->TM+OmpA->	bacteria>proteobacteria>gammaproteobacteria	1
SIG+TIMbarrel-><-PSE<-SIG+TM(s)*<-TM(s)	bacteria>proteobacteria>gammaproteobacteria	1
SIG+TIMbarrel-><-SIG+TM<-SIG+TM(s)*<-TM(s)	bacteria>proteobacteria>gammaproteobacteria	1
SIG+TM->?->?->?->Cluster57_2clades->SIG+TM(s)*->NACHT->TET-TPase->?->Cluster103_2clades-><-?<-TM(s)<-SIG+TM(s)	bacteria>proteobacteria>gammaproteobacteria	1
SIG+TM->?->?->Cluster57_2clades->SIG+TM(s)*->NACHT->TET-TPase->?->?->?->SIG+TM(s)->SIG+TM->	bacteria>proteobacteria>gammaproteobacteria	1
SIG+TM->?->?->SIG+TM(s)*->NACHT->TET-TPase->	bacteria>proteobacteria>gammaproteobacteria	1
SIG+TM->?-><-?*<-PspC	bacteria>other unclassified bacteria	1
SIG+TM->?->SIG+TM(s)->TM(s)->SIG+TM(s)*->SIG+BetaPropeller->SIG+BetaPropeller->TM->Cluster112_5clades->GT->DOUBLECORTIN->	bacteria>proteobacteria>gammaproteobacteria	1
SIG+TM->?->SIG+TM(s)*->SIG+TM(s)->TM(s)->?-><-?||?-><-ISOCOT+SIR2	bacteria>proteobacteria>alphaproteobacteria	1
SIG+TM-><-?*	bacteria>firmicutes	1
SIG+TM->CheC->?->CheC->SIG+NtrC-AAA+FIS-HTH->?->SIG+TM(s)*-><-?||SIG+CHASE3+TM+SHELIX+HISKIN->REC->	bacteria>proteobacteria>alphaproteobacteria	1
SIG+TM->CheC->?->CheC->SIG+NtrC-AAA+FIS-HTH->?->SIG+TM(s)*->SIG+CHASE3+TM+SHELIX+HISKIN->REC->	bacteria>proteobacteria>alphaproteobacteria	1
SIG+TM->CheC->?->CheC->SIG+NtrC-AAA+FIS-HTH->SIG+TM(s)*-><-?||?-><-ISOCOT	bacteria>proteobacteria>alphaproteobacteria	1
SIG+TM->CheC->?->CheC->SIG+TM(s)->SIG+NtrC-AAA+FIS-HTH->SIG+TM(s)*->	bacteria>proteobacteria>alphaproteobacteria	1
SIG+TM->CheC->?->CheC->SIG+TM(s)*->SIG+APATPase->ParA-Soj-PloopNTPase->?->?-><-Cluster440_3clades<-Cluster588_2clades	bacteria>proteobacteria>alphaproteobacteria	1
SIG+TM->CheC->Cluster263_2clades->NACHT->?->SIG+Lysozyme->FilH->SIG+TM(s)*->TM+OmpA->?->HPT+HISKIN+CheW->?-><-SIG+TM(s)	bacteria>synergistetes	1
SIG+TM->HIN-HTH->CHTH->SIG+TM(s)->SIG+TM->SIG+TM(s)->TM(s)->SIG+TM(s)*->	bacteria>actinobacteria	1
SIG+TM->LiaI-LiaF-TM*->	bacteria>other unclassified bacteria	1
SIG+TM->SIG+TM(s)-><-?||SIG+TM->SIG+TM(s)->TM(s)->SIG+TM(s)*->SIG+APATPase->ParA-Soj-PloopNTPase->?->SIGMA-HTH->FilH->	bacteria>spirochaetes	1
SIG+TM->SIG+TM(s)->SIG+TM->SIG+TM(s)->TM(s)->?->?->SIG+TM(s)*->SIG+APATPase->ParA-Soj-PloopNTPase->SIGMA-HTH->REC->SFII-RAD3->	bacteria>proteobacteria>gammaproteobacteria	1
SIG+TM->SIG+TM(s)->SIG+TM->SIG+TM(s)->TM(s)->SIG+TM(s)*->	bacteria>proteobacteria>gammaproteobacteria	1
SIG+TM->SIG+TM(s)->SIG+TM->SIG+TM(s)->TM(s)->SIG+TM(s)*->SIG+APATPase->ParA-Soj-PloopNTPase->REC->HPT+HISKIN+CheW->CheW->CheC->CheD->	bacteria>firmicutes	1
SIG+TM->SIG+TM(s)->SIG+TM->SIG+TM(s)->TM(s)->SIG+TM(s)*->SIG+APATPase->ParA-Soj-PloopNTPase->SIGMA-HTH->REC->SFII-RAD3->HPT+HISKIN+CheW->CheW->	bacteria>proteobacteria>gammaproteobacteria	1
SIG+TM->SIG+TM(s)->SIG+TM->SIG+TM(s)->TM(s)->SIG+TM(s)*->SIG+APATPase->ParA-Soj-PloopNTPase->SIGMA-HTH->SIG+TM(s)->	bacteria>other proteobacteria	1
SIG+TM->SIG+TM(s)->SIG+TM->SIG+TM(s)->TM(s)->SIG+TM(s)*->SIG+APATPase->ParA-Soj-PloopNTPase->SIGMA-HTH->SIG+TM(s)->	bacteria>proteobacteria>betaproteobacteria	1
SIG+TM->SIG+TM(s)->SIG+TM->SIG+TM(s)->TM(s)->SIG+TM(s)*->SIGMA-HTH->SIG+BetaPropeller->SIG+BetaPropeller->	bacteria>firmicutes	1
SIG+TM->SIG+TM(s)->TM(s)->SIG+TM(s)*->	bacteria>other unclassified bacteria	1
SIG+TM->SIG+TM(s)->TM(s)->SIG+TM(s)*->?->?->?->?-><-?<-DOC+BirA-HTH	bacteria>spirochaetes	1
SIG+TM->SIG+TM(s)->TM(s)->SIG+TM(s)*->?->?->?->HMA+TM(s)->	bacteria>spirochaetes	1
SIG+TM->SIG+TM(s)->TM(s)->SIG+TM(s)*->SIG+APATPase->ParA-Soj-PloopNTPase->?->SIGMA-HTH->	bacteria>proteobacteria>zetaproteobacteria	1
SIG+TM->SIG+TM(s)->TM(s)->SIG+TM(s)*->SIG+APATPase->ParA-Soj-PloopNTPase->?->SIGMA-HTH->?->?->TM(s)->	bacteria>proteobacteria>zetaproteobacteria	1
SIG+TM->SIG+TM(s)->TM(s)->SIG+TM(s)*->SIG+APATPase->ParA-Soj-PloopNTPase->?->SIGMA-HTH->FilH->	bacteria>spirochaetes	1
SIG+TM->SIG+TM(s)->TM(s)->SIG+TM(s)*->SIG+APATPase->ParA-Soj-PloopNTPase->PilZ->SIGMA-HTH->	bacteria>firmicutes	1
SIG+TM->SIG+TM(s)->TM(s)->SIG+TM(s)*->SIG+APATPase->ParA-Soj-PloopNTPase->SIGMA-HTH->	bacteria>fcb group	1
SIG+TM->SIG+TM(s)->TM(s)->SIG+TM(s)*->SIG+BetaPropeller->SIG+BetaPropeller->?->TM->Cluster112_5clades->?->DOUBLECORTIN->	bacteria>proteobacteria>gammaproteobacteria	1
SIG+TM->SIG+TM(s)->TM(s)->SIG+TM(s)*->SIG+BetaPropeller->SIG+BetaPropeller->?->TM->Cluster112_5clades->GT->DOUBLECORTIN->	bacteria>proteobacteria>gammaproteobacteria	1
SIG+TM->SIG+TM(s)->TM(s)->SIG+TM(s)*->SIG+BetaPropeller->SIG+BetaPropeller->Cluster541_2clades->TM->Cluster112_5clades->GT->DOUBLECORTIN->	bacteria>proteobacteria>betaproteobacteria	1
SIG+TM->SIG+TM(s)->TM(s)->SIG+TM(s)*->SIG+BetaPropeller->SIG+BetaPropeller->SIG+SAF->TM->Cluster112_5clades->GT->DOUBLECORTIN->	bacteria>proteobacteria>gammaproteobacteria	1
SIG+TM->SIG+TM(s)->TM(s)->TM(s)->SIG+TM(s)*->	bacteria>firmicutes	1
SIG+TM->SIG+TM(s)->TM(s)->TM(s)->SIG+TM(s)*->SIG+APATPase->?->?->CheRN-Alpha+CheR-Methylase->?->SIG+TM(s)->TM+OmpA->	bacteria>firmicutes	1
SIG+TM(s)->?->LiaI-LiaF-TM+Toast-rack*->	archaea>euryarchaeota	1
SIG+TM(s)->?->SIG+SAF->?->?->?->SIG+TM(s)*->SIGMA-HTH-><-?||?->?-><-?<-?<-Cluster768_2clades	bacteria>proteobacteria>alphaproteobacteria	1
SIG+TM(s)->?->SIG+SAF->?->?->?->SIG+TM(s)*->SIGMA-HTH-><-Cluster854_2clades	bacteria>proteobacteria>alphaproteobacteria	1
SIG+TM(s)-><-?<-PspC(s)+LiaI-LiaF-TM+Toast-rack(s)*<-PADR-HTH	bacteria>fcb group	1
SIG+TM(s)-><-PspC(s)+LiaI-LiaF-TM+Toast-rack(s)*<-PADR-HTH	bacteria>fcb group	1
SIG+TM(s)->SIG+TM->PSE->PSE->SIG+TM(s)*->	bacteria>actinobacteria	1
SIG+TM(s)->SIG+TM->SIG+TM(s)->TM(s)->?->SIG+TM(s)*->SIG+APATPase->PSE->?->SIGMA-HTH->?->HD->	bacteria>other unclassified bacteria	1
SIG+TM(s)->SIG+TM->SIG+TM(s)->TM(s)->SIG+TM(s)*->	bacteria>proteobacteria>deltaproteobacteria	1
SIG+TM(s)->SIG+TM->SIG+TM(s)->TM(s)->SIG+TM(s)*->	bacteria>spirochaetes	1
SIG+TM(s)->SIG+TM->SIG+TM(s)->TM(s)->SIG+TM(s)*->?->SIG+APATPase->ParA-Soj-PloopNTPase->?->?->SIGMA-HTH->	bacteria>spirochaetes	1
SIG+TM(s)->SIG+TM->SIG+TM(s)->TM(s)->SIG+TM(s)*-><-Cluster538_3clades<-DHH||?-><-?<-?<-?||Cluster302_2clades->	bacteria>others	1
SIG+TM(s)->SIG+TM->SIG+TM(s)->TM(s)->SIG+TM(s)*->NACHT->	bacteria>proteobacteria>betaproteobacteria	1
SIG+TM(s)->SIG+TM->SIG+TM(s)->TM(s)->SIG+TM(s)*->SIG+APATPase->	bacteria>chloroflexi	1
SIG+TM(s)->SIG+TM->SIG+TM(s)->TM(s)->SIG+TM(s)*->SIG+APATPase->	bacteria>other unclassified bacteria	1
SIG+TM(s)->SIG+TM->SIG+TM(s)->TM(s)->SIG+TM(s)*->SIG+APATPase->ParA-Soj-PloopNTPase->?->SIG+TM(s)->TM+OmpA->?->SIG+TM(s)->	bacteria>nitrospirae	1
SIG+TM(s)->SIG+TM->SIG+TM(s)->TM(s)->SIG+TM(s)*->SIG+APATPase->ParA-Soj-PloopNTPase->?->SIGMA-HTH->	bacteria>fcb group	1
SIG+TM(s)->SIG+TM->SIG+TM(s)->TM(s)->SIG+TM(s)*->SIG+APATPase->ParA-Soj-PloopNTPase->SIGMA-HTH->	bacteria>other unclassified bacteria	1
SIG+TM(s)->SIG+TM->SIG+TM(s)->TM(s)->SIG+TM(s)*->SIG+APATPase->ParA-Soj-PloopNTPase->SIGMA-HTH->SIG+TM(s)->	bacteria>other proteobacteria	1
SIG+TM(s)->SIG+TM->SIG+TM(s)->TM(s)->SIG+TM(s)*->SIG+APATPase->ParA-Soj-PloopNTPase->SIGMA-HTH->SIG+TM(s)->TM+OmpA->	bacteria>proteobacteria>gammaproteobacteria	1
SIG+TM(s)->SIG+TM->SIG+TM(s)->TM(s)->SIG+TM(s)*->SIGMA-HTH->CheC->	bacteria>acidobacteria	1
SIG+TM(s)->SIG+TM(s)->?->?->?->PADR-HTH->?*->	bacteria>fcb group	1
SIG+TM(s)->TM(s)-><-?<-?<-?<-?<-NACHT<-SIG+TM(s)*	bacteria>proteobacteria>gammaproteobacteria	1
SIG+TM(s)->TM(s)->SIG+TM(s)*->NACHT->	bacteria>proteobacteria>betaproteobacteria	1
SIG+TM(s)->TM(s)->SIG+TM(s)*->SIG+APATPase->ParA-Soj-PloopNTPase->	bacteria>nitrospirae	1
SIG+TM(s)->TM(s)->SIG+TM(s)*->SIG+APATPase->ParA-Soj-PloopNTPase->?->SIGMA-HTH->REC->CheC->CheC->	bacteria>deferribacteres	1
SIG+TM(s)->TM(s)->SIG+TM(s)*->SIG+APATPase->ParA-Soj-PloopNTPase->SIGMA-HTH->?->SIG+BetaPropeller->SIG+BetaPropeller->SIG+SAF->	bacteria>proteobacteria>deltaproteobacteria	1
SIG+TM(s)->TM(s)->SIG+TM(s)*->SIG+APATPase->ParA-Soj-PloopNTPase->SIGMA-HTH->REC->SFII-RAD3->HPT+HISKIN+CheW->REC->	bacteria>proteobacteria>gammaproteobacteria	1
SIG+TM(s)->TM+OmpA->REC->SFII-RAD3->TM(s)->SIG+TM(s)*->SIG+APATPase->?->SIGMA-HTH-><-?<-Cluster40_2clades<-SIG+SAF||Cluster115_5clades->	bacteria>proteobacteria>betaproteobacteria	1
SIG+TM(s)*->	bacteria>acidobacteria	1
SIG+TM(s)*->	bacteria>nitrospirae	1
SIG+TM(s)*->	bacteria>others	1
SIG+TM(s)*->	bacteria>pvc group	1
SIG+TM(s)*->?->?->?->?-><-?||SIG+TM(s)->	bacteria>proteobacteria>alphaproteobacteria	1
SIG+TM(s)*->?->?->?->?->Cluster426_2clades->	bacteria>proteobacteria>epsilonproteobacteria	1
SIG+TM(s)*->?->?->?-><-?<-?<-HMA+TM(s)	bacteria>proteobacteria>epsilonproteobacteria	1
SIG+TM(s)*->?->?-><-?||SIG+SHELIX+GGDEF-><-Cluster294_3clades<-?<-ATP-LIGASE+HhH-RADC+BRCT	bacteria>proteobacteria>epsilonproteobacteria	1
SIG+TM(s)*->?->?-><-?<-?<-NACHT	bacteria>proteobacteria>alphaproteobacteria	1
SIG+TM(s)*->?->?->SIGMA-HTH->	bacteria>other unclassified bacteria	1
SIG+TM(s)*->?-><-REC	bacteria>proteobacteria>epsilonproteobacteria	1
SIG+TM(s)*->?->ABC-ATPase(s)->PSYN-><-?<-Cluster949_2clades	bacteria>proteobacteria>epsilonproteobacteria	1
SIG+TM(s)*->?->ParA-Soj-PloopNTPase->SIG+APATPase->	bacteria>other unclassified bacteria	1
SIG+TM(s)*->?->ParA-Soj-PloopNTPase->SIGMA-HTH->?->?->Cluster307_3clades->	bacteria>proteobacteria>betaproteobacteria	1
SIG+TM(s)*->?->ParA-Soj-PloopNTPase->SIGMA-HTH->?-><-SIG+BetaPropeller	bacteria>proteobacteria>alphaproteobacteria	1
SIG+TM(s)*->?->ParA-Soj-PloopNTPase->SIGMA-HTH->Cluster307_3clades->SIG+TM(s)->TM+OmpA->	bacteria>proteobacteria>betaproteobacteria	1
SIG+TM(s)*-><-?||?->?->?->tRNA-><-Cluster891_2clades<-NACHT<-Cluster776_2clades	bacteria>pvc group	1
SIG+TM(s)*->Cluster255_4clades->	bacteria>proteobacteria>gammaproteobacteria	1
SIG+TM(s)*->Cluster49_2clades->NACHT->?->?-><-CHTH<-HIN-HTH	bacteria>proteobacteria>gammaproteobacteria	1
SIG+TM(s)*->Cluster49_2clades->NACHT->Cluster59_2clades->	bacteria>proteobacteria>betaproteobacteria	1
SIG+TM(s)*->Cluster49_2clades->NACHT->Cluster59_2clades->?->Cluster24_2clades->SIG+TM(s)->SIG+TM->	bacteria>proteobacteria>gammaproteobacteria	1
SIG+TM(s)*->Cluster49_2clades->NACHT->Cluster59_2clades->PSE->Cluster24_2clades->PSE->SIG+TM->SIG+TM(s)->PSE->Cluster759_2clades->	bacteria>proteobacteria>gammaproteobacteria	1
SIG+TM(s)*->Cluster558_3clades->	bacteria>proteobacteria>alphaproteobacteria	1
SIG+TM(s)*->FHA->NACHT->?->Cluster63_2clades->SIG+TM(s)->SIG+TM->SIG+TM(s)->	bacteria>proteobacteria>gammaproteobacteria	1
SIG+TM(s)*->FHA->NACHT->TET-TPase->?->Cluster63_2clades->SIG+TM(s)->SIG+TM->	bacteria>proteobacteria>betaproteobacteria	1
SIG+TM(s)*->NACHT->	bacteria>others	1
SIG+TM(s)*->NACHT->	bacteria>proteobacteria>gammaproteobacteria	1
SIG+TM(s)*->NACHT->TET-TPase->	bacteria>proteobacteria>gammaproteobacteria	1
SIG+TM(s)*->NACHT->TET-TPase->?->?->SIG+TM(s)->SIG+TM->SIG+TM(s)->	bacteria>proteobacteria>gammaproteobacteria	1
SIG+TM(s)*->ParA-Soj-PloopNTPase->SIGMA-HTH->?->?-><-Cluster120_5clades	bacteria>proteobacteria>alphaproteobacteria	1
SIG+TM(s)*->ParA-Soj-PloopNTPase->SIGMA-HTH-><-?<-Cluster120_5clades	bacteria>proteobacteria>alphaproteobacteria	1
SIG+TM(s)*->SIG+APATPase->	bacteria>pvc group	1
SIG+TM(s)*->SIG+APATPase->?->ParA-Soj-PloopNTPase->SIGMA-HTH->REC->SFII-RAD3->HPT+HISKIN+CheW->	bacteria>proteobacteria>gammaproteobacteria	1
SIG+TM(s)*->SIG+APATPase->?->SIGMA-HTH->SIG+TM(s)->	bacteria>pvc group	1
SIG+TM(s)*->SIG+APATPase->ParA-Soj-PloopNTPase->	bacteria>thermotogae	1
SIG+TM(s)*->SIG+APATPase->ParA-Soj-PloopNTPase->SIGMA-HTH->	bacteria>nitrospirae	1
SIG+TM(s)*->SIG+APATPase->ParA-Soj-PloopNTPase->SIGMA-HTH->?-><-Cluster511_3clades	bacteria>proteobacteria>gammaproteobacteria	1
SIG+TM(s)*->SIG+APATPase->ParA-Soj-PloopNTPase->SIGMA-HTH-><-?||REC->SFII-RAD3->HPT+HISKIN+CheW->	bacteria>proteobacteria>gammaproteobacteria	1
SIG+TM(s)*->SIG+APATPase->ParA-Soj-PloopNTPase->SIGMA-HTH->PSE->SFII-RAD3->HPT+HISKIN+CheW->REC->ParA-Soj-PloopNTPase->	bacteria>proteobacteria>gammaproteobacteria	1
SIG+TM(s)*->SIG+APATPase->ParA-Soj-PloopNTPase->SIGMA-HTH->SIG+BetaPropeller->SIG+BetaPropeller->	bacteria>proteobacteria>deltaproteobacteria	1
SIG+TM(s)*->SIG+APATPase->SIG+BetaPropeller->	bacteria>firmicutes	1
SIG+TM(s)*->SIG+APATPase->SIGMA-HTH->SIG+BetaPropeller->?->Cluster120_5clades->Cluster420_2clades->Cluster307_3clades->	bacteria>proteobacteria>deltaproteobacteria	1
SIG+TM(s)*->SIG+TM->Cluster27_3clades->?->?->SIG+TM->?->Cluster133_3clades->	bacteria>proteobacteria>betaproteobacteria	1
SIG+TM(s)*->SIG+TM(s)->?->?->?->?-><-NACHT<-SIG+BetaPropeller	bacteria>proteobacteria>alphaproteobacteria	1
SIG+TM(s)*->SIG+TM(s)->?->?->?->?-><-REC	bacteria>proteobacteria>alphaproteobacteria	1
SIG+TM(s)*->SIG+TM(s)->?->?->?->?->SIG+TarH+TM+HAMP+MA->	bacteria>proteobacteria>alphaproteobacteria	1
SIG+TM(s)*->SIG+TM(s)->TM(s)->?->Cluster425_2clades->Cluster446_2clades->	bacteria>proteobacteria>alphaproteobacteria	1
SIG+TM(s)*->SIG+TM(s)->TM(s)->?->Cluster425_2clades->Cluster446_2clades-><-REC	bacteria>proteobacteria>alphaproteobacteria	1
SIG+TM(s)*->SIGMA-HTH->	bacteria>fcb group	1
SIG+TM(s)*->TM->Cluster154_3clades-><-SIG+TPR	bacteria>proteobacteria>betaproteobacteria	1
SIG+TM*->?-><-?||LiaI-LiaF-TM+Toast-rack*->?->REC->	bacteria>firmicutes	1
SIG+TM*->?->LiaI-LiaF-TM+Toast-rack*->	bacteria>firmicutes	1
SIG+TM*->?->LiaI-LiaF-TM+Toast-rack*->?->REC->?->?-><-Cluster538_3clades	bacteria>firmicutes	1
SIG+TM*->?->LiaI-LiaF-TM+Toast-rack*->?->REC-><-TM(s)	bacteria>firmicutes	1
SIG+TM*->?->SIG+TM(s)+Toast-rack*->?->REC->?->?-><-ABC-ATPase(s)<-Cluster558_3clades	bacteria>firmicutes	1
SIG+TM+Toast-rack*->PSE->REC->	bacteria>firmicutes	1
SIG+TPR->?->?->TM->Cluster301_2clades->SIG+TM(s)*->	bacteria>proteobacteria>alphaproteobacteria	1
SIG+TPR-><-?<-TM<-REC<-SIG+TM(s)*<-TPR<-?<-FHA+TM	bacteria>proteobacteria>alphaproteobacteria	1
SIG+TPR-><-?<-TM<-SIG+TM(s)*<-?<-?<-FHA+TM	bacteria>proteobacteria>alphaproteobacteria	1
SIG+TPR-><-Cluster154_3clades<-TM<-SIG+TM(s)*<-TPR<-Cluster172_2clades<-FHA+TM<-Cluster251_2clades	bacteria>proteobacteria>gammaproteobacteria	1
SIGMA-HTH->?->?->?->?*->	bacteria>other unclassified bacteria	1
SIGMA-HTH->?->?-><-SIGMA-HTH<-ParA-Soj-PloopNTPase<-SIG+APATPase<-SIG+TM(s)*<-TM(s)<-SIG+TM(s)<-SIG+TM<-SIG+TM(s)<-SIG+TM<-CheC<-CheC	bacteria>proteobacteria>deltaproteobacteria	1
SIGMA-HTH->?->?->LiaI-LiaF-TM+Toast-rack*->	bacteria>firmicutes	1
SIGMA-HTH->?->?->LiaI-LiaF-TM+Toast-rack*->FURR-HTH->	bacteria>firmicutes	1
SIGMA-HTH->?->?->LiaI-LiaF-TM+Toast-rack+EP1*-><-Cluster306_3clades	bacteria>acidobacteria	1
SIGMA-HTH->?->?->LiaI-LiaF-TM+Toast-rack+EP1*-><-MORC	bacteria>acidobacteria	1
SIGMA-HTH->?->?*->?->?*->	bacteria>acidobacteria	1
TM->?->?->?-><-DUF1700-alpha-helical+PspC+LiaI-LiaF-TM*<-PADR-HTH	bacteria>fcb group	1
TM->?->?->SIG+TM(s)->?->?->?->SIG+TM(s)*->SIG+TM(s)->TM(s)->	bacteria>proteobacteria>alphaproteobacteria	1
TM->?->?->SIG+TM(s)->?->SIG+TM(s)*->SIG+TM(s)->TM(s)->	bacteria>proteobacteria>alphaproteobacteria	1
TM->?->?->SIG+TM(s)->SIG+TM->SIG+TM(s)->TM(s)->SIG+TM(s)*->SIGMA-HTH->CheC->CheC->	bacteria>acidobacteria	1
TM-><-tRNA||?-><-?*	bacteria>other unclassified bacteria	1
TM->CheC->?->SIG+TM(s)->SIG+TM->SIG+TM(s)->TM(s)->SIG+TM(s)*->SIG+APATPase->ParA-Soj-PloopNTPase->	bacteria>aquificae	1
TM->CheC->?->SIG+TM(s)->SIG+TM->SIG+TM(s)->TM(s)->SIG+TM(s)*->SIG+APATPase->ParA-Soj-PloopNTPase->SIGMA-HTH->?->?->REC->HPT+HISKIN+CheW->	bacteria>nitrospirae	1
TM->CheC->?->SIG+TM(s)->SIG+TM->SIG+TM(s)->TM(s)->SIG+TM(s)*->SIG+APATPase->ParA-Soj-PloopNTPase->SIGMA-HTH->CheRN-Alpha+CheR-Methylase->REC->	bacteria>nitrospirae	1
TM->CheC->?->SIG+TM(s)->SIG+TM->SIG+TM(s)->TM(s)->SIG+TM(s)*->SIGMA-HTH->CheC->CheC->SIG+BetaPropeller->SIG+BetaPropeller->?->TM->	bacteria>acidobacteria	1
TM->CheC->CheC->REC->SIG+TM(s)*->	bacteria>firmicutes	1
TM->CheC->CheC->SIG+TM->SIG+TM(s)->SIG+TM(s)->TM(s)->SIG+TM(s)*->?->?->?->?-><-?<-REC	bacteria>actinobacteria	1
TM->CheC->CheC->SIG+TM->SIG+TM(s)->SIG+TM(s)->TM(s)->SIG+TM(s)*->?->?->?-><-?<-REC<-?<-REC	bacteria>actinobacteria	1
TM->CheC->SIG+TM->SIG+TM(s)->SIG+TM->SIG+TM(s)->TM(s)->SIG+TM(s)*->SIG+APATPase->ParA-Soj-PloopNTPase->PilZ->SIGMA-HTH->?->SIG+BetaPropeller->SIG+BetaPropeller->	bacteria>firmicutes	1
TM->CheC->SIG+TM->SIG+TM(s)->SIG+TM->SIG+TM(s)->TM(s)->SIG+TM(s)*->SIG+APATPase->ParA-Soj-PloopNTPase->PilZ->SIGMA-HTH->SIG+BetaPropeller->CheD->CheRN-Alpha+CheR-Methylase->	bacteria>firmicutes	1
TM->CheC->SIG+TM->SIG+TM(s)->SIG+TM->SIG+TM(s)->TM(s)->SIG+TM(s)*->SIG+APATPase->ParA-Soj-PloopNTPase->PilZ->SIGMA-HTH->SIG+BetaPropeller->SIG+BetaPropeller->CheD->	bacteria>firmicutes	1
TM->SIG+TM->SIG+TM(s)->SIG+TM->SIG+TM(s)->TM(s)->SIG+TM(s)*->SIGMA-HTH->SIG+BetaPropeller->SIG+BetaPropeller->PSE->?->CheW->CheD->REC->	bacteria>firmicutes	1
TM->SIG+TM->SIG+TM(s)->SIG+TM->TM(s)->SIG+TM(s)*->SIG+APATPase->ParA-Soj-PloopNTPase->PilZ->SIGMA-HTH->	bacteria>firmicutes	1
TM(s)->?->?-><-?<-?<-?<-?*<-Cluster856_2clades	bacteria>fcb group	1
TM(s)-><-?*<-LiaI-LiaF-TM*<-?<-?<-?<-ABC-ATPase<-?<-?<-Cluster253_2clades	bacteria>firmicutes	1
TM(s)-><-?||?->?->?->?->PADR-HTH->DUF1700-alpha-helical+PspC+LiaI-LiaF-TM*->	bacteria>fcb group	1
TM(s)->SIG+TM(s)*->	bacteria>actinobacteria	1
TM(s)->SIG+TM(s)*-><-?<-Cluster426_2clades	bacteria>proteobacteria>gammaproteobacteria	1
TM(s)->SIG+TM(s)*-><-CHTH<-HIN-HTH	bacteria>proteobacteria>betaproteobacteria	1
TM(s)->SIG+TM(s)*->NACHT->	bacteria>proteobacteria>betaproteobacteria	1
TM(s)->SIG+TM(s)*->PSE-><-DICT<-Cluster40_2clades	bacteria>proteobacteria>gammaproteobacteria	1
TM(s)->SIG+TM(s)*->SIG+APATPase->	bacteria>proteobacteria>gammaproteobacteria	1
TM(s)->SIG+TM(s)*->SIG+APATPase->?->SIGMA-HTH->?-><-?<-?<-Cluster288_2clades	bacteria>proteobacteria>betaproteobacteria	1
TM(s)->SIG+TM(s)*->SIG+APATPase->?->SIGMA-HTH->?-><-?<-SIG+MHYT+TM(s)+GGDEF+EAL	bacteria>proteobacteria>betaproteobacteria	1
TM(s)->SIG+TM(s)*->SIG+APATPase->?->SIGMA-HTH->SIG+TM(s)->?->TM+OmpA->	bacteria>pvc group	1
TM(s)->SIG+TM(s)*->SIG+APATPase->?->SIGMA-HTH->SIG+TM(s)->TM+OmpA->?-><-Cluster865_2clades	bacteria>pvc group	1
TM(s)->SIG+TM(s)*->SIG+APATPase->Cluster216_2clades->SIG+TM->SIGMA-HTH->	bacteria>proteobacteria>gammaproteobacteria	1
TM(s)->SIG+TM(s)*->SIG+APATPase->ParA-Soj-PloopNTPase->	bacteria>spirochaetes	1
TM(s)->SIG+TM(s)*->SIG+APATPase->ParA-Soj-PloopNTPase->?->SIGMA-HTH->FilH->	bacteria>spirochaetes	1
TM(s)->SIG+TM(s)*->SIG+APATPase->ParA-Soj-PloopNTPase->SIGMA-HTH->SIG+TM->?-><-DICT	bacteria>proteobacteria>betaproteobacteria	1
TM(s)->SIG+TM(s)*->SIG+APATPase->ParA-Soj-PloopNTPase->SIGMA-HTH->SIG+TM(s)->TM+OmpA-><-SIG+MHYT+TM(s)+GGDEF+EAL	bacteria>proteobacteria>betaproteobacteria	1
TM(s)->SIG+TM(s)*->SIG+TM->SIGMA-HTH->	bacteria>proteobacteria>gammaproteobacteria	1
TM+OmpA->TM->SIG+TM->SIG+TM(s)->SIG+TM->SIG+TM(s)->TM(s)->SIG+TM(s)*->SIGMA-HTH->?->SIG+BetaPropeller->ABC-ATPase->	bacteria>firmicutes	1
TPR(s)->SIG+TM->SIG+TM(s)->TM(s)->SIG+TM(s)*->SIG+BetaPropeller->SIG+BetaPropeller->Cluster355_3clades->TM->Cluster112_5clades->GT->DOUBLECORTIN->	bacteria>proteobacteria>gammaproteobacteria	1
TPR(s)->SIG+TM->SIG+TM(s)->TM(s)->SIG+TM(s)*->SIG+BetaPropeller->SIG+BetaPropeller->SIG+SAF->TM->Cluster112_5clades->GT->DOUBLECORTIN->	bacteria>proteobacteria>gammaproteobacteria	1
TRAM+METHYLASE->tRNA->PSYN->?->TM(s)->SIG+TM(s)*->SIG+APATPase->ParA-Soj-PloopNTPase->SIGMA-HTH->SIG+TM(s)->TM+OmpA-><-Cluster408_2clades<-MORC	bacteria>proteobacteria>betaproteobacteria	1
